а	ʔaː
абадз	aːbaːd͡z
абакъэ	aːbaːqa
абан	aːbaːn
абас	aːbaːs
абдзах	aːbd͡zaːx
абрагъу	aːbraːʁʷ
абрадж	aːbraːd͡ʒ
абрамыжъу	aːbraːməʐʷ
абхъаз	aːbχaːz
абыкъу	aːbəqʷ
абэгъоплъ	aːbaʁʷapɬ
абэдзэкъуай	aːbad͡zaqʷaːj
абэуйэй	abawjaj
агурджашъу	aːɡʷərd͡ʒaːʂʷ
агъо	aːʁʷa
агъунэр	aːʁʷənar
аддэ	aːdda
аджал	aːd͡ʒaːl
аджар	aːd͡ʒaːr
адрабгъу	aːdəraːbʁʷ
ады	ʔaːdə
адыгагъ	aːdəɣaːʁ
адыгэ	aːdəɣa
адыгэбзэ	aːdəɣabza
адыгэкъэб	aːdəɣaqab
адыгэхэ	aːdəɣaxa
адырабгъу	aːdəraːbʁʷ
адэ	aːda
адэбз	aːdabz
адэкӏо	aːdakʷʼa
адэм	ʔaːdam
адэхъу	aːdaχʷ
ае	aːja
азыфагу	aːzəfaːɡʷ
азэ	aːza
азэнадж	aːzanaːd͡ʒ
ай	aːj
акул	aːkʷəl
акъужъ	aːqʷəʐ
акъуш	aːqʷəʃ
акъыл	ʔaːqəl
акъылыгъу	aːqələʁʷ
ал	aːl
алашэ	aːlaːʃa
алъмэкъ	aːɬmaq
алыркъэб	aːlərqab
алырэгъу	aːləraʁʷ
алырэгъушӏ	aːləraʁʷʃʼ
алэдышъ	aːladəʂ
амал	aːmaːl
амдэз	aːmdaz
амылкъан	aːməlqaːn
амырмэ	aːmarma
амышӏэр	aːməʃʼar
амыщ	aːməɕ
амэ	aːma
амэрмэ	aːmarma
анай	aːnaːj
анахь	aːnaːħ
анджэрэф	aːnd͡ʒaraf
анезе	anajzaj
антыр	aːntər
анэ	ʔaːna
анэбзыу	anabzəw
анэбзэ	aːnabza
анэдэлъфыбзэ	aːnadaɬfəbza
анэл	aːnal
анэу	aːnaw
анэхь	aːnaħ
анэш	ʔaːnaʃ
анэшыпхъу	ʔaːnaʃəpχʷ
апкь	aːpkʲ
апкӏмыжъ	aːpkʲməʐʷ
апкӏмыжъ	aːpt͡ʃməʐʷ
апкӏхалъхь	aːpkʲxaːɬħ
апкӏхалъхь	aːpt͡ʃxaːɬħ
апкӏхьэн	aːpkʲħan
апкӏхьэн	aːpt͡ʃħan
апкӏшъхьэтэт	aːpkʲʂħatat
апкӏшъхьэтэт	aːpt͡ʃʂħatajt
апс	aːps
апхъурэлъф	aːpχʷəraɬf
апч	aːpt͡ʃ
апшъ	aːpʂ
апшъышъ	ʔaːpʂəʂ
апшъэр	aːpʂar
апэ	aːpa
апэрэ	aːpara
апэрэу	aːparaw
апӏэ	aːpʼa
ар	aːr
арап	aːraːp
арба	arbaː
аргъой	aːrʁʷaj
аргъойпаӏу	aːrʁʷajaːʔʷ
аргъэй	aːrʁaj
аргъэйфыгу	aːrʁajfəɡʷ
арджан	aːrd͡ʒaːn
арми	aːma
армэ	aːrma
армэу	aːrmaw
армэугъ	aːrmawʁ
архъожъ	aːrχʷaʐ
архъуажъ	aːrχʷaːʐ
архъуан	aːrχʷaːn
арымэ	aːrəma
арышъ	aːrəʂ
арышъхьае	aːrəʂħaːja
арэущтэу	aːrawɕtaw
аслъан	ʔasɬaːn
аслъаншыр	aːsɬaːnʃər
асэ	ʔaːsa
атакъэ	ʔataːqa
атэ	aːta
атэш	ʔaːtaʃ
атэшыпхъу	ʔaːtaʃəpχʷ
ау	aːw
аужым	aːwʒəm
аушыджэр	aːwʃəd͡ʒar
афы	aːfə
ахъ	aːχ
ахъу	aːχʷə
ахъчалъ	aːχt͡ʃaːɬ
ахъчапс	aːχt͡ʃaːps
ахъчашъхь	aːχt͡ʃaːʂħ
ахъчэ	aːχt͡ʃa
ахъчэбэг	aːχt͡ʃabaɣ
ахъчэбэдзэр	aːχt͡ʃabad͡zar
ахъчэдэфый	aːχt͡ʃadafəj
ахъчэжъгъэй	aːχt͡ʃaʐʁaj
ахъчэзэблэхъущ	aːχt͡ʃazablaχʷən
ахъчэмыкӏу	aːχt͡ʃaməkʷʼ
ахъчэнэпцӏ	aːχt͡ʃanapt͡sʼ
ахъчэнэпцӏшӏ	aːχt͡ʃanapt͡sʼʃʼ
ахъщалъ	aːχɕaːɬ
ахъщапс	aːχʃaːps
ахъщашъхь	aːχʃaːʂħ
ахъщэ	aːχʃa
ахъщэбэг	aːχʃabaɣ
ахъщэбэдзэр	aːχʃabad͡zar
ахъщэдэфый	aːχʃadafəj
ахъщэжъгъэй	aːχʃaʐʁaj
ахъщэзэблэхъущ	aːχʃazablaχʷən
ахъщэмыкӏу	aːχʃaməkʷʼ
ахъщэнэпцӏ	aːχɕanapt͡sʼ
ахъщэнэпцӏшӏ	aːχʃanapt͡sʼʃʼ
ахын	aːxən
ахэр	aːxar
ачъэ	aːtʂa
ачъэгъашъу	aːtʂaʁaːʂʷ
ачъэжъ	aːχt͡ʃaʐ
ашхырэ	aːʃxəra
ашъо	aːʂʷa
ашъоку	aːʂʷakʷ
ашъоцуакъ	aːʂʷat͡sʷaːɡʷ
ашъоцуакъ	aːʂʷat͡ʃʷaːɡʷ
ашъыу	aːʃʷʼəw
ашэ	ʔaːʃa
ашӏэгъудж	aːʃʼaʁʷəd͡ʒ
ащ	aːɕ
ащгъум	aːɕʁʷəm
ащтэу	aːʃtəw
аӏууц	aːʔʷəwət͡s
багьэ	baːɡʲa
баджэ	baːd͡ʒa
бадзэ	baːd͡za
бадзэпсэ	baːd͡zapsa
бадэ	baːda
бадэ	baːdam
бае	baːja
баигъ	baːjəʁ
бакъмэр	baːqmar
бамыкӏ	baːmək
баргъ	baːrʁ
басмэ	baːsma
батыр	baːtər
батыргъэгъ	baːtərʁaʁ
батыргъэн	baːtərʁan
батырыгъ	baːtərəʁ
бахъсымэ	baːχsəma
башлыкъ	baːʃləq
башӏэ	baːʃʼa
бащэ	baːɕa
баӏо	baːʔʷa
бганэ	bɣaːna
бгъагъэ	bʁaːʁa
бгъакъэ	bʁaːqa
бгъалъэ	bʁaːɬa
бгъашхъо	bʁaːʃχʷa
бгъашъухъо	bʁaːʃʷχʷa
бгъо	bʁʷa
бгъодж	bʁʷad͡ʒ
бгъодэкӏын	bʁʷadat͡ʃʼən
бгъодэт	bʁʷadad
бгъодэхьан	bʁʷadaaħaːn
бгъотагъэ	bʁʷataːʁa
бгъотэн	bʁʷatan
бгъотэрым	bʁʷtarəm
бгъу	bʁʷə
бгъуагъэ	bʁʷaːʁa
бгъуанэ	bʁʷaːna
бгъузагъ	bʁʷəzaːʁ
бгъузэ	bʁʷəza
бгъундж	bʁʷənd͡ʒ
бгъунджырыкӏу	bʁʷənd͡ʒərəkʷʼ
бгъурышӏ	bʁʷərəʃʼ
бгъусы	bʁʷəsə
бгъушы	bʁʷəʃə
бгъэ	bʁa
бгъэбзы	bʁabzə
бгъэгу	bʁaɡʷ
бгъэгъакӏ	bʁaʁaːt͡ʃ
бгъэджыб	bʁad͡ʒər
бгъэжъ	bʁaʐ
бгъэкӏапх	bʁat͡ʃʼaːpx
бгъэкӏыхь	bʁakʲʼəħ
бгъэкӏыхь	bʁat͡ʃʼəħ
бгъэкӏэс	bʁat͡ʃas
бгъэкӏэхь	bʁakʲʼaħ
бгъэкӏэхь	bʁat͡ʃʼaħ
бгъэлыб	bʁaləb
бгъэн	bʁan
бгъэны	bʁanə
бгъэпс	bʁaps
бгъэузы	bʁawəzə
бгъэхалъхь	bʁaxaːɬħ
бгъэхэлъ	bʁaxaɬ
бгъэхэӏу	bʁaxaʔʷ
бгъэхэӏушъхь	bʁaxaʔʷəʂħ
бгъэӏас	bʁaʔaːs
бгы	bɣə
бгыбзэ	bɣəbza
бгыгъуан	bɣəʁʷaːn
бгыкъу	bɣəqʷ
бгыкъупхъ	bɣəqʷəpχ
бгылъэ	bɣəɬa
бгынагъэ	bɣənaːʁa
бгынэжьыгъэ	bɣənaʑəʁa
бгынэн	bɣənan
бгыпэ	bɣəpa
бгырыпх	bɣərəpx
бгырыпхышъхь	bɣərəpxəʂħ
бгырыс	bɣərəs
бгычап	bɣət͡ʃaːp
бгычӏэ	bɣətʂa
бгышъхь	bɣəʂħa
бгэн	jabɣən
бгэрый	bɣərəj
белэ	bajla
бжалэ	bʒaːla
бжамэ	bʒaːma
бжъаб	bʐaːb
бжъабгъу	bʐaːbʁʷə
бжъако	bʐaːkʷa
бжъакъо	bʐaːqʷa
бжъакъэ	bʐaːqa
бжъалъ	bʐaːɬ
бжъанэ	bʐaːna
бжъапэ	bʐaːpa
бжъау	bʐaːw
бжъащэ	bʐaːɕa
бжъэ	bʐa
бжъэдыгъу	bʐadəʁʷ
бжъэкумыл	bʐakʷəməl
бжъэкъожъый	bʐaqʷaʐəj
бжъэмый	bʐaməj
бжъэмыяпщ	bʐaməjaːpɕ
бжъэу	bʐaw
бжъэшъу	bʐaʂʷ
бжыб	bʒəb
бжыдзэ	bʒəd͡za
бжым	bʒəm
бжымы	bʒəmə
бжыхьакӏэ	bʒəħaːt͡ʃa
бжыхьапэ	bʒəħaːpa
бжыхьас	bʒəħaːs
бжыхьэ	bʒəħa
бжыхьэбадзэ	bʒəħabaːd͡za
бжьахъо	bʑaːχʷa
бжьашӏо	bʑaːʃʷʼa
бжьащэ	bʑaːɕa
бжьаӏо	bʑaːʔʷa
бжьы	bʑə
бжьыго	bʑaːɡʷa
бжьыгъэ	bʑəʁa
бжьыко	bʑaːkʷa
бжьыны	bʑənə
бжьыныкӏ	bʑənəkʲʼ
бжьыныуц	bʑənəwts
бжьыныф	bʑənəf
бжьыныфщыгъу	bʑənəfɕəʁʷ
бжьыныфыкӏ	bʑənəfəkʲʼ
бжьыныфыц	bʑənəfəts
бжьышӏо	bʑəʃʷʼa
бжьэ	bʑa
бжьэбын	bʑabən
бжьэгъалӏэ	bʑaʁaːɬʼa
бжьэмат	bʑamaːt
бжьэматэ	bʑamaːta
бжьэпащ	bʑapaːɕ
бжьэпчӏ	bʑapt͡ʃ
бжьэхъон	bʑaχʷan
бжьэцы	bʑat͡sə
бжьэшх	bʑaʃx
бзагьэ	bzaːɡʲa
бзаджэ	bzaːd͡ʒa
бзако	bzaːkʷa
бзакӏо	bzaːkʷʼa
бзалъ	bzaːɬ
бзашӏу	bzaːʃʷʼ
бзудэгу	bzəwdaɡʷ
бзукӏэзэгох	bzəwt͡ʃazaɡʷax
бзушхъу	bzəwʃχʷ
бзы	bzə
бзыгъ	bzəʁ
бзыиплъ	bzəjəpɬ
бзый	bzəj
бзылъфыгъэ	bzəlfəʁa
бзылъфыгъэ	bzəɬfəʁa
бзын	bzən
бзыпхъэ	bzəpχa
бзытэн	bzətan
бзыу	bzəw
бзыужъый	bzəwʐəj
бзыукъолэн	bzəwqʷalan
бзыукъуай	bzəwqʷaːj
бзыукӏалъэ	bzəwt͡ʃʼaːɬa
бзыукӏьалъэ	bzəwkʲʼaːɬa
бзыукӏэплъ	bzəwkʲapɬ
бзыулъахъ	bzəwɬaːχ
бзыуубыт	bzəwwəbət
бзыухьакуаку	bzəwħaːkʷaːkʷ
бзыуцыф	bzəwt͡səf
бзыушыр	bzəwʃər
бзыфы	bzəfə
бзыхьан	bzəħaːn
бзыхьаф	bzəħaːf
бзыхьафынчъ	bzəħaːfəntʂ
бзэ	bza
бзэбзэн	bzabzan
бзэгохь	bzaɡʷaħ
бзэгу	bzaɡʷ
бзэгужъый	bzaɡʷʐəj
бзэгуп	bzaɡʷəp
бзэгурацу	bzaɡʷəraːt͡sʷ
бзэгурацу	bzaɡʷəraːt͡ʃʷ
бзэгухь	bzaɡʷəħ
бзэгухьын	bzaɡʷəħən
бзэджай	bzad͡ʒaːj
бзэджашӏэ	bzad͡ʒaːʃʼa
бзэджэн	bzad͡ʒan
бзэджэнрылъф	bzad͡ʒanrəɬf
бзэджэрылъф	bzad͡ʒarəɬf
бзэен	bzajan
бзэил	bzajəl
бзэкъулъ	bzaqʷəɬ
бзэмай	bzamaːj
бзэмкъэшӏэныгъ	bzamqaʃʼanəʁ
бзэмыӏу	bzaməʔʷ
бзэмэ	bzaːma
бзэныб	bzanəb
бзэпс	bzaps
бзэрэбзэн	bzarabzan
бзэу	bzaw
бзэутэ	bzawta
бзэхабзэ	bzaxaːbz
бзэхын	bzaxən
бзэшэн	bzaʃan
бзэшӏэныгъ	bzaʃʼanəʁ
бзэшӏэныгъэлӏ	bzaʃʼanəʁaɬʼ
блабжъ	blaːbʐ
благъо	blaːʁʷa
благъэ	blaːʁa
блантхъэ	blaːntχa
блапцӏэ	blaːpt͡sʼa
блахэ	blaːxa
блашхъо	blaːʃχʷa
блашъо	blaːʂʷa
блашъхьэ	blaːʂħa
блегъэзыкӏын	blajʁazəkʲən
блегъэкӏын	blajʁakʲʼən
бледзын	blajd͡zən
блефын	blajfən
блехын	blajxən
блещын	blajɕən
блихын	blajxən
блы	blə
блы	bɮə
блыгу	bləɡʷ
блыгучӏ	bləɡʷt͡ʃ
блыгучӏад	bləɡʷt͡ʃʼaːd
блын	blən
блыны	blənə
блыныкӏ	blənət͡ʃ
блыпкъ	bləpq
блыпкъыжъый	bləpqəʐəj
блыпкъышъхь	bləpqəʂħ
блыпкъыщ	bləpqəɕ
блыпэ	bləpa
блырыбл	blərəbl
блэ	bla
блэбгъу	blabʁʷə
блэбгъуп	blabʁʷəp
блэбгъуплъ	blabʁʷəpɬ
блэбыбыкӏын	blabəbət͡ʃʼən
блэбыбын	blabəbən
блэгъагъ	blaʁaːʁ
блэгъожъ	blaʁʷaʐ
блэгъэжъ	blaʁaʐ
блэгъэзыкӏын	bɮaʁazət͡ʃʼən
блэгъэкӏын	blaʁat͡ʃən
блэгьан	blad͡ʒaːn
блэгьан	blaɡʲaːn
блэдзын	blad͡zən
блэкӏыгъэу	bɮat͡ʃʼəʁaw
блэкӏын	blat͡ʃʼən
блэкӏьын	blakʲʼən
блэлъэтын	blaɬatən
блэмыу	blaməw
блэн	blan
блэнагъ	blanaːʁ
блэнашкӏэ	blanaːʃkʼa
блэнэукъ	blanawq
блэнэуц	blanawt͡s
блэпкӏын	blapt͡ʃʼən
блэпкӏьын	blaptkʲʼən
блэплъын	blapɬən
блэпцэжъый	blapt͡ʃaʐəj
блэрыпс	blarəps
блэун	blawən
блэуц	blawt͡s
блэфын	bɮafən
блэхъушъутын	blaχʷəʂʷtən
блэхын	blajxən
блэхьадж	blaħaːd͡ʒ
блэшъутын	blaəʂʷtən
блэщын	blajɕən
брацэ	braːt͡sa
быбхалъ	bəbxaːɬ
быбыжьын	bəbəʑən
быбылъ	bəbəɬ
быбын	bəbən
быбыпӏ	bəbəpʼ
быбэ	bəba
быбэтэн	bəbatan
быгъу	bəʁʷ
быдзашъу	bəd͡zaːʂʷ
быдзталхьэ	bəd͡ztaːlħa
быдзы	bəd͡zə
быдзылъ	bəd͡zəɬ
быдзып	bəd͡zəp
быдзытелъхьэ	bəd͡zətajɬħ
быдзыщ	bəd͡zəɕ
быжъутэн	bəʐʷətan
быкӏу	bəkʷʼə
былътырыку	bəɬtərəkʷ
былъытырыкӏу	bəɬətərəkʷʼ
былым	bələm
былымахъу	bələmaːχʷ
былымбэлыдж	bələmbaləd͡ʒ
былымтыгъу	bələmtəʁʷ
былымылы	bələmələ
былымылӏэ	bələməɬʼa
былымыпс	bələməps
былыхъу	bələχʷ
бын	bən
бынд	bənd
быны	bənə
бынынчъэ	bənənt͡ʃa
быныуын	bənəwən
быраб	bəraːb
бырамыты	bəraːmətə
быратӏ	bəraːtʼ
бырацэ	bəraːt͡sa
быргусыргу	bərɡʷəsərɡʷ
быргытӏырг	bərɣətʼərɣ
быркусын	bərkʷʁsən
бырсыр	bərsər
бырсырыл	bərsərəl
бырсырын	bərsərən
бырыпх	pərəpx
бырыугъэчэрэгъу	bərəwʁat͡ʃaraʁʷ
бырыукъ	bərəwq
быслымэн	bəsləman
бысылмэн	bəsəlman
бысым	bəsəm
бытхъэ	bətχa
быты	bətə
бытырбыф	batərbəf
бытӏы	bətʼə
быун	bəwən
быяужьын	bəjaːwʑən
быяун	bəjaːwʑəb
быяупӏ	bəjaːwpʼ
бэ	ba
бэбахь	babaːħ
бэгу	baɡʷ
бэгъашӏэ	baʁaːʃʼa
бэгъон	baʁʷan
бэгъэгус	baʁaɡʷəs
бэгыгъэ	baɣəʁa
бэгын	baɣən
бэгьэхъ	baɡʲaχ
бэджанд	bad͡ʒaːnd
бэджы	bad͡ʒə
бэджыджэн	bad͡ʒəd͡ʒan
бэджыхъ	bad͡ʒəχ
бэджэбы	bad͡ʒabə
бэджэжъые	bad͡ʒaʐəja
бэджэндыку	bad͡ʒandakʷ
бэджэндэутын	baʒandawtən
бэджэшъ	baːd͡ʒaʂ
бэджэщыр	bad͡ʒaɕər
бэдзэгъалӏэ	bad͡zaʁaːɬʼa
бэдзэжьын	bad͡zaʑən
бэдзэнэшъу	bad͡zanaʂʷ
бэдзэогъумаз	bad͡zawaʁʷəmaːz
бэдзэр	bad͡zar
бэдзэры	bad͡zarə
бэдзэрыкӏу	bad͡zarəkʷʼ
бэдзэубыт	bad͡zawbət
бэдзэукӏ	bad͡zawəkʲ
бэдзэукӏ	bad͡zawət͡ʃ
бэежъ	bajaʐ
бэжъу	baʐʷ
бэйкол	baːkʷal
бэйкъогъуз	baːjqʷaʁʷəz
бэкълауэ	baqlaːwa
бэкъогъу	baqʷaʁw
бэкъон	baqʷan
бэкъу	baqʷ
бэкъудадз	baqʷdaːd͡z
бэкӏай	bakʲaːj
бэлахь	balaːħ
бэлъф	baɬf
бэлыдж	baləd͡ʒ
бэлыджакӏэ	baləd͡ʒaːkʼa
бэлыджэпс	baləd͡ʒaps
бэлэрыгъ	balarəʁ
бэнакӏо	banaːkʷʼa
бэнанэ	banaːna
бэнжъый	banʐəj
бэнтехъу	bantajχʷ
бэны	banə
бэнытӏ	banətʼ
бэнэн	banan
бэнэныгъ	bananəʁ
бэон	bawan
бэрауты	baraːwtə
бэрбэр	barbar
бэрджахь	bard͡ʒaːħ
бэрэ	bara
бэрэкъащ	baraqaːɕ
бэрэскэжъый	baraskaʐəj
бэрэскэф	baraskaf
бэрэчэт	barakat
бэрэӏумаф	baraʔʷəmaːf
бэскъэн	basqan
бэслъыный	basɬənəj
бэткэлӏ	batkaɬʼ
бэты	batə
бэхьал	baħaːl
бэшхы	baʃxə
бэшэрэб	baʃarab
бэшӏагъ	baʃʼaːʁ
бэщ	baɕ
бэщкъорэгъ	baɕqʷaraʁ
бэщышӏ	baɕəʃʼ
бэщыӏ	baɕəʔ
бэӏул	baʔʷəl
гогон	ɡʷaɡʷan
гогонжъый	ɡʷaɡʷanʐəj
гокӏын	ɡʷat͡ʃʼən
гомыхь	ɡʷaməħ
гонэхь	ɡʷanaħ
гоон	ɡʷawan
гопкӏэн	ɡʷapt͡ʃʼan
гопэгъу	ɡʷapaʁʷ
гопэн	ɡʷapan
гоутын	ɡʷawtən
гоуцон	ɡʷawt͡sʷan
гохьан	ɡʷaħaːn
гохьы	ɡʷaħə
гощын	ɡʷaɕən
гоӏу	ɡʷaħə
гоӏулӏэн	ɡʷəʔʷəɬʼan
гоӏэн	ɡʷaʔan
гу	ɡʷə
гуадз	ɡʷaːd͡z
гуао	ɡʷaːwa
гуапэ	ɡʷaːpa
гуащэ	ɡʷaːɕa
губгъо	ɡʷəbʁʷa
губгъэ	ɡʷəbʁa
губгъэн	ɡʷəbʁan
губж	ɡʷəbʒ
губжыгъошӏу	ɡʷəbʒəʁʷaʃʷʼ
губжын	ɡʷəbʒən
губжыпх	ɡʷəbʒəpx
губзыгъ	ɡʷəbzəʁ
гугъон	ɡʷəʁʷan
гугъу	ɡʷəʁʷ
гугъун	ɡʷəʁən
гугъын	ɡʷəʁən
гугъэ	ɡʷəʁa
гугъэн	ɡʷəʁan
гудэ	ɡʷəda
гуегъун	ɡʷəjaʁʷən
гуеӏун	ɡʷjaʔʷən
гужъ	ɡʷəʐ
гужъуакӏэ	ɡʷəʒʷaːt͡ʃa
гужъыен	ɡʷəʐəjan
гузэгу	ɡʷəzaɡʷ
гузэжъогъу	ɡʷəzaʒʷaʁʷ
гузэжъон	ɡʷəzaʒʷan
гузэжъопх	ɡʷzaʒʷapx
гуигъэун	ɡʷəjʁawən
гуих	ɡʷəjəx
гукъау	ɡʷəqaːw
гукъэгъэкӏын	ɡʷəqaʁat͡ʃʼən
гукъэгъэкӏьын	ɡʷəqaʁakʲʼən
гукъэкӏыжьын	ɡʷəqat͡ʃʼəʑən
гукъэкӏын	ɡʷəqat͡ʃʼən
гукъэкӏьыжьын	ɡʷəqakʲʼəʑən
гукъэкӏьын	ɡʷəqakʲʼən
гукӏае	ɡʷət͡ʃʼaːja
гукӏэгъу	ɡʷət͡ʃʼaʁʷ
гукӏэн	ɡʷət͡ʃan
гулъытэ	ɡʷəɬəta
гулъытэн	ɡʷəɬətan
гумыӏан	ɡʷəməʔaːn
гумыӏу	ɡʷəməʔʷ
гумэкӏыгъу	ɡʷəmat͡ʃəʁʷ
гумэкӏын	ɡʷəmat͡ʃən
гун	ɡʷən
гунахь	ɡʷənaːħ
гуп	ɡʷəp
гупсэн	ɡʷəpsan
гупсэф	ɡʷəpsaf
гупсэфыпӏ	ɡʷəpsafəpʼ
гупцӏанэ	ɡʷəpt͡sʼaːna
гупч	ɡʷəpt͡ʃ
гупшысэ	ɡʷəpʃəsa
гупшысэн	ɡʷəpʃəsan
гупыт	ɡʷəpət
гупэн	əɡʷəpan
гурихьан	ɡʷərəjħən
гурихьэн	ɡʷərəjħən
гурыгъэӏон	ɡʷərəʔʷan
гурышхъу	ɡʷərəʃχʷ
гурыӏон	ɡʷərəʔʷan
гухахъо	ɡʷəxaːχʷa
гухэгъэкӏын	ɡʷəxaʁat͡ʃʼən
гухэкӏ	ɡʷəxat͡ʃʼ
гухэкӏын	ɡʷəxat͡ʃʼən
гуцаф	ɡʷət͡saːf
гушӏон	ɡʷəʃʷʼan
гушӏопсӏын	ɡʷəʃʷʼapsʼən
гушӏуагъо	ɡʷəʃʷʼaːʁʷa
гушӏуагъэ	ɡʷəʃʷʼaːʁa
гушӏуапкӏэ	ɡʷəʃʷʼapt͡ʃʼa
гущ	ɡʷəɕ
гущаӏэ	ɡʷəɕaːʔa
гущыӏал	ɡʷəɕəʔaːl
гущыӏалъ	ɡʷəɕəʔaːɬ
гущыӏанчъэ	ɡʷəɕəʔant͡ʂʼa
гущыӏап	ɡʷəʃʷʼap
гущыӏэ	ɡʷəɕəʔa
гущыӏэгъал	ɡʷəɕəʔaʁaːɮ
гущыӏэгъу	ɡʷəɕəʔaʁʷ
гущыӏэмпае	ɡʷəɕəʔampaːja
гущыӏэн	maɡʷɕəʔan
гущыӏэрые	ɡʷəɕəʔarəja
гущыӏэухыгъэ	ɡʷəɕəʔawxəʁa
гуӏэн	ɡʷəʔan
гъаблэ	ʁaːbɮa
гъажъо	ʁaːʒʷa
гъалэ	ʁaːɮa
гъатхэ	ʁaːtxa
гъаф	ʁaːf
гъашӏэ	ʁaːʃʼa
гъо	ʁʷa
гъогогъу	ʁʷaɡʷaʁʷ
гъогу	ʁʷaɡʷ
гъогумаф	ʁʷaɡʷmaːf
гъогуонэкӏуныр	ʁʷaɡʷəwanakʷʼənər
гъогурыгъуазэ	ʁʷaɡʷrəʁʷaːza
гъогъон	ʁʷaʁʷan
гъогын	ʁʷaɣən
гъожьы	ʁʷaʑə
гъожьыплъыжь	ʁʷaʑpɬəʑə
гъожьышэплъ	ʁʷaʑəʃapɬ
гъоз	ʁʷaz
гъозадж	ʁʷazaːd͡ʒ
гъозалъ	ʁʷazaːɬ
гъозэн	ʁʷazan
гъозэнэфы	ʁʷazanafə
гъоин	ʁʷajən
гъойщай	ʁʷajɕaːj
гъойщэен	ʁʷajɕajan
гъолагъ	ʁʷaɮaːʁ
гъолагъу	ʁʷaɮaːʁ
гъолагъэ	ʁʷaɮaːʁa
гъолъын	ʁʷaɬən
гъолъыпӏэ	ʁʷaɬəpʼa
гъомыл	ʁʷaməɮ
гъомылапхъэ	ʁʷaməlaːpχa
гъонлагъэ	ʁʷanɮaːʁa
гъончэдж	ʁʷant͡ʃad͡ʒ
гъоплъашъо	ʁʷapɬəʂʷa
гъоплъашъу	ʁʷapɬaːʂʷ
гъоплъышъо	ʁʷapɬəʂʷa
гъопэкӏаку	ʁʷaːpat͡ʃʼaːkʷ
гъопэкӏьаку	ʁʷaːpakʲʼaːkʷ
гъопэкӏьэхь	ʁʷaːpakʲʼaħ
гъопэкӏэхь	ʁʷaːpat͡ʃʼaħ
гъотын	ʁʷatən
гъоу	ʁʷaw
гъофы	ʁʷafə
гъочӏэгъ	ʁʷat͡ʂʼaʁ
гъошэгь	ʁʷaʃaɡʲ
гъощэн	ʁʷaɕan
гъу	ʁʷə
гъуазэ	ʁʷaːza
гъуамэ	ʁʷaːma
гъуанэ	ʁʷaːna
гъуаплъэ	ʁʷaːpɬa
гъуапэ	ʁʷaːpa
гъубдж	ʁʷəbd͡ʒ
гъугъэ	ʁʷəʁa
гъуен	ʁʷəjan
гъукӏэ	ʁʷət͡ʃʼa
гъумы	ʁʷəmə
гъун	ʁʷən
гъунапкъэ	ʁʷənaːpqa
гъунгьэ	ʁʷənɡʲa
гъунд	ʁʷənd
гъунджэ	ʁʷərd͡ʒa
гъунэ	ʁʷəna
гъунэгъу	ʁʷənaʁʷ
гъунэфын	ʁʷənafən
гъургьэ	ʁʷərɡʲa
гъурз	ʁʷərz
гъуркӏ	ʁʷərt͡ʃʼ
гъусэ	ʁʷəsa
гъусэн	ʁʷəsan
гъутхьан	ʁʷətħaːn
гъучӏы	ʁʷət͡ʃʼə
гъучӏыбзыу	ʁʷət͡ʂʼəbzəw
гъучӏынэ	ʁʷət͡ʂʼəna
гъучӏыӏунэ	ʁʷət͡ʂʼəʔʷəna
гъучӏӏунэ	ʁʷət͡ʂʼəʔʷəna
гъушъы	ʁʷəʂə
гъушъын	ʁʷəʂən
гъы	ʁə
гъыбзэ	ʁəbza
гъымакъэ	ʁəmaːqa
гъын	ʁən
гъынэнэн	ʁənanan
гъычгъэ	ʁət͡ʃʁa
гъэ	ʁa
гъэбылъын	ʁabəɬən
гъэбыяун	ʁabəjaːn
гъэбэдзэжьын	ʁabad͡zaʑən
гъэгожъын	ʁaɡʷaʐən
гъэгоӏэн	ʁaɡʷaʔan
гъэгубжын	ʁaɡʷəbʒən
гъэгумэкӏын	ʁaɡʷəmat͡ʃən
гъэгъун	ʁaʁʷən
гъэгъушъын	ʁaʁʷʂən
гъэгъын	ʁaʁən
гъэгъэн	maʁaʁan
гъэгьэн	ʁaɡʲan
гъэделэн	ʁadajlan
гъэджыджэн	ʁad͡ʒəd͡ʒan
гъэджэн	ʁad͡ʒan
гъэдэӏон	ʁadaʔʷən
гъэжъон	ʁaʒʷan
гъэжъэн	ʁaʐan
гъэжьэн	jaʁaʑan
гъэзалъэ	ʁazaːɬa
гъэзет	ʁazjat
гъэзетщапӏэ	ʁazjatɕaːpʼa
гъэзэжьын	ʁazaʑən
гъэзэзэн	ʁazazan
гъэзэн	ʁazan
гъэзэщын	ʁazaʃən
гъэкощын	ʁakʷaɕən
гъэкуон	ʁakʷəwan
гъэкъын	ʁaqən
гъэкъэбзэн	ʁaqabzan
гъэкъэркъэтэн	ʁaqarqatan
гъэкьэн	ʁakʲan
гъэкьэрэгъун	ʁakaraʁʷən
гъэкьэрэзын	ʁakʲarazən
гъэкӏодын	ʁakʷʼadən
гъэкӏосэн	ʁakʷʼasan
гъэкӏын	ʁat͡ʃʼən
гъэкӏэрэкӏэн	ʁat͡ʃarat͡ʃan
гъэлагъэ	ʁalaːʁa
гъэлакӏо	ʁaɮaːkʷʼa
гъэлъэжъон	ʁaɬaʐʷan
гъэлъэпӏэн	ʁaɬapʼan
гъэлъэхъу	ʁaɬaχʷ
гъэлыгъон	ʁaɮəʁʷan
гъэлыгьын	ʁaləɡʲən
гъэлыджын	ʁaləd͡ʒən
гъэлэжьэн	ʁalaʑan
гъэлэлэн	ʁalalan
гъэлӏэн	ʁaɬʼan
гъэмартын	ʁamaːrtən
гъэмафэ	ʁamaːfa
гъэмысэн	ʁaməsan
гъэмэхъэшэн	ʁamaχaʃan
гъэны	ʁanə
гъэнэфэн	ʁanafan
гъэон	ʁawan
гъэохъун	ʁawaχʷən
гъэпкӏын	ʁapt͡ʃʼən
гъэплъын	ʁapɬən
гъэпрэзэн	ʁaprazan
гъэпскӏын	ʁapsət͡ʃʼən
гъэпскӏыпӏэ	ʁapst͡ʃəpʼa
гъэпсыкӏ	ʁapsət͡ʃʼ
гъэпсыкӏын	ʁapsət͡ʃʼən
гъэпсыкӏьын	ʁapsəkʲʼən
гъэпсын	ʁapsən
гъэпсэн	ʁʷatən
гъэпсэфакӏо	ʁapsafaːkʷʼa
гъэпсэфыгъо	ʁapsafəʁʷa
гъэпсэфын	ʁapsafən
гъэпсӏэн	ʁapsʼən
гъэпхын	jaʁapxən
гъэпцӏакӏо	ʁapt͡sʼaːkʷʼa
гъэпцӏэн	ʁapt͡sʼən
гъэпшъын	ʁapʂən
гъэпщтын	ʁapɕtən
гъэпщын	ʁapɕən
гъэпщынэн	ʁapɕənan
гъэпщэн	ʁapɕan
гъэпыин	ʁapəjən
гъэпыутын	ʁapəwtən
гъэпэн	əʁapan
гъэпӏоркӏын	ʁapʷʼant͡ʃʼən
гъэпӏэркӏьын	ʁapʼarkʲən
гъэрекӏопагъэ	ʁarakʷʼapaːʁa
гъэрсысын	ʁarsəsən
гъэрэзэн	ʁarazan
гъэрэкӏо	ʁarakʷʼa
гъэрэкӏопагъэ	ʁarakʷʼapaːʁa
гъэсагъ	ʁasaːʁ
гъэсмэджэн	ʁasmad͡ʒan
гъэстын	ʁastən
гъэстыныпхъ	ʁastənəpχ
гъэсымэджэн	ʁasmad͡ʒan
гъэсысын	ʁasəsən
гъэсэкъатын	ʁasaqaːtən
гъэсэкӏэн	ʁasat͡ʃʼan
гъэсэн	ʁasan
гъэсэныгъэ	ʁasanəʁa
гъэсэпэтхыдэ	ʁasapatxəda
гъэсэфытхыдэ	ʁasafətxəda
гъэсэхъуджэн	ʁasaχʷəd͡ʒan
гъэткӏун	ʁatkʷʼən
гъэтхапэмаз	ʁatxaːpamaːz
гъэтхъын	ʁatχən
гъэтхъэжьын	ʁaːtχaʑən
гъэтхъэн	ʁatχan
гъэтэрэзыжьын	ʁat͡sat͡ʃaʑən
гъэтэрэзын	ʁatarazən
гъэтӏылъын	ʁatʼəɬən
гъэтӏысын	ʁatʼəsən
гъэтӏэпӏын	ʁatʼapʼən
гъэтӏэтӏэн	ʁatʼatʼan
гъэузын	ʁawzən
гъэунэзэн	ʁawnazan
гъэунэн	ʁawənən
гъэунэхъун	ʁawnaχʷʁn
гъэунэшкӏун	ʁawnaʃkʷʼən
гъэупысӏэн	ʁawpsʼan
гъэупыцӏэн	ʁawpsʼan
гъэупэпцӏын	ʁawpapt͡sʼən
гъэупӏысӏэн	ʁawpsʼan
гъэупӏыцӏэн	ʁawpʼət͡sʼan
гъэупӏэпӏэн	ʁawpʼapʼan
гъэутхъон	ʁawtχʷan
гъэутэшъон	ʁawtaʃʷan
гъэутӏэпӏын	ʁawtʼapʼən
гъэухьазырын	ħaːzərən
гъэуцун	ʁawət͡ʃʷən
гъэучыен	ʁawt͡ʃəjan
гъэушъэбын	ʁawʂabən
гъэушӏоин	ʁawʂʷajən
гъэушӏоркъын	ʁawʃʷʼarqən
гъэуэн	ʁawan
гъэфэбапӏэ	ʁafabaːpʼa
гъэхъужьын	ʁaχʷəʑən
гъэхъун	ʁaχʷən
гъэхъэн	ʁaχan
гъэхьазырын	ħaːzərən
гъэхьын	jaʁaħən
гъэцохъон	ʁat͡sʷaχʷan
гъэцэкӏэжьын	ʁat͡sat͡ʃaʑən
гъэцэкӏэжьыпӏэ	ʁat͡sət͡ʃaʑəpʼa
гъэцэкӏэн	ʁat͡sat͡ʃan
гъэцӏыон	ʁat͡sʼəwan
гъэцӏырэн	ʁat͡sʼəran
гъэцӏэтхын	ʁat͡sʼatxən
гъэчанын	ʁat͡ʃaːnən
гъэчъэхын	jaʁat͡ʂaxən
гъэчэн	ʁat͡ʃan
гъэчэрэгъун	ʁat͡ʃaraʁʷən
гъэчэрэзын	ʁat͡ʃarazən
гъэшъуен	ʁaʂʷjan
гъэшъхъын	ʁaʂəχən
гъэшъхъэгъ	ʁaʂχəʁa
гъэшъхъэшъхъэн	ʁaʂχaʂχan
гъэшъыпкъэжьын	ʁaʂəpqaʑən
гъэшъыхъыгъ	ʁaʂχəʁa
гъэшӏон	ʁaʃʷʼan
гъэшӏоӏун	ʁaʃʷʼaʔʷən
гъэшӏыкӏьэен	ʁaʃʼəkʲʼajan
гъэшӏыкӏэен	ʁaʃʼət͡ʃʼajan
гъэшӏэгъон	ʁaʃʼaəʁʷan
гъэшӏэгъоны	ʁaʃʼaʁʷanə
гъэщтын	ʁaɕtən
гъэщтэн	ʁaɕtan
гъэщын	ʁaɕən
гъэщынэн	ʁaɕənan
гъэӏонтӏэн	ʁaʔʷantʼan
гъэӏортӏэн	ʁaʔʷartʼan
гъэӏорышӏэн	ʁaʔʷarʃʼan
гъэӏулэн	ʁaʔʷəlan
гъэӏэсэн	ʁaʔasan
гыен	ɣəjan
гыкӏалъэ	ɣət͡ʃʼaːɬa
гыкӏыгъ	ɣət͡ʃʼəʁ
гыкӏын	ɣət͡ʃən
гыкӏэн	ɣət͡ʃʼan
гын	ɣən
гыны	ɣənə
гыныплъ	ɣənəpɬ
гырзын	ɣərzən
гьанэ	ɡʲaːna
гьары	ɡʲaːrə
гьаур	ɡʲaːwər
гьи	ɡʲəj
гьэгу	ɡʲaɡʷ
гьэгуалъэ	ɡʲaɡʷaːɬa
гьэгун	ɡʲaɡʷən
гьэнэпылъапӏ	ɡʲanapəɬaːpʼ
гьэфы	ɡʲafə
гьэч	ɡʲat͡ʃ
гьэш	ɡʲaʃ
гьэщту	ɡʲaɕtəw
гэ	ɣa
дагъо	daːʁʷa
дагъэ	daːʁa
дадыу	daːdəw
дае	daːja
дакъэ	daːqa
дакӏэ	daːt͡ʃa
дампӏ	daːmpʼ
данэ	daːna
дао	daːwa
дапӏэ	daːpʼa
даргу	daːrɡʷ
дасэ	daːsa
даут	dawət
дауш	daːwəʃ
дахэ	daːxa
дашӏэ	daːʃʼa
даӏо	daːʔʷa
дегъэбзыхыкӏэн	ʁapsən
деджэгъу	dajd͡ʒaʁʷ
дежъыон	dajʐəwan
дежъыуакӏо	dajʐəwaːkʷa
дежъыун	dajʐəwan
декъузэн	dajqʷəzan
декъыен	dajqəjan
делагъэ	dajlaːʁa
делашъу	dajlaːʃʷ
делъэсыкӏын	dajɬasət͡ʃən
делъэсэен	dajɬasajan
делъэшъоен	dajɬaʂʷajan
делэ	dajla
делэ	dajɮa
делэжъ	dajlaʐ
делэхъан	dajlaχaːn
делэщ	dajlaɕ
деокӏын	dajwat͡ʃən
дес	dajs
дестэ	dajsta
дестэгъу	dajstaʁʷ
десэгъу	dajsaʁʷ
деузэндын	dajwzandən
деузэнкӏын	dajwzant͡ʃən
деукъон	dajqʷan
деупӏэпӏэн	dajwpʼapʼan
деусын	dajsən
деусэн	dajsan
деутын	dajtən
деушъэн	dajʂan
дефыен	dajfəjan
дехын	dajxəx
дехьыен	dajħəjan
дехьыхын	dajħəxən
дещыен	dajɕəjan
деӏэн	dajʔan
джабгъо	d͡ʒaːbʁʷa
джагъо	d͡ʒaːʁʷa
джагъу	d͡ʒaʁʷ
джадэ	d͡ʒaːda
джае	d͡ʒaːja
джакӏо	d͡ʒaːkʷʼa
джамбырыу	d͡ʒaːmbərəw
джамбырыугъазэ	d͡ʒaːmbərəwʁaːza
джан	d͡ʒaːn
джанкъылъыщ	d͡ʒaːnəɬəɕ
джантый	d͡ʒaːntəj
джанщэрэхъ	d͡ʒaːnɕaraχ
джанэ	d͡ʒaːna
джаргъэн	d͡ʒaːrʁan
джары	d͡ʒaːrə
джарэу	d͡ʒaːraw
джасэ	d͡ʒaːsa
джау	d͡ʒaːw
джаузэ	d͡ʒaːwza
джаур	d͡ʒaːwər
джаущтэу	d͡ʒaːwəɕtaw
джашъо	d͡ʒaːʃʷa
джащыгъум	d͡ʒaːɕəʁʷəm
джы	d͡ʒə
джыбэ	d͡ʒəba
джыджэн	mad͡ʒəd͡ʒan
джыдэдэм	d͡ʒədadam
джыкӏэ	d͡ʒət͡ʃʼa
джын	d͡ʒən
джынапцӏэ	d͡ʒənaːpt͡sʼa
джынджыф	d͡ʒənd͡ʒəf
джыны	d͡ʒənə
джынэ	d͡ʒəna
джынэс	d͡ʒənas
джынэузэщ	d͡ʒənawzaɕ
джырыкъу	d͡ʒərəqʷ
джырэ	d͡ʒəra
джырэблагъ	d͡ʒərablaːr
джырэкӏэ	d͡ʒərat͡ʃʼa
джыхашъо	d͡ʒəxaːʃʷa
джыхьан	d͡ʒəħaːn
джыхьынэм	d͡ʒəħənam
джыхэкӏотэн	d͡ʒaxakʷʼatan
джыхэлъэдэн	d͡ʒəxaɬadan
джыхэон	d͡ʒəxawan
джыхэпкӏьэн	d͡ʒəxapkʲʼan
джыхэпкӏэн	d͡ʒəxapt͡ʃʼan
джыхэупсӏэн	d͡ʒəxawpsʼan
джыхэхьэн	d͡ʒəxaħan
джэгогъу	d͡ʒaɡʷaʁʷ
джэгу	d͡ʒaɡʷ
джэгуакӏо	d͡ʒaɡʷaːkʷʼa
джэгуалъэ	d͡ʒaɡʷaːɬa
джэгун	d͡ʒaɡʷən
джэгупӏэ	d͡ʒaɡʷəpʼa
джэгъогъу	d͡ʒaʁʷəɡʷ
джэгъогъун	d͡ʒaʁʷəɡʷən
джэгъолӏ	d͡ʒaʁʷaɬʼ
джэгъун	d͡ʒaʁʷən
джэгъучӏэлъ	d͡ʒaʁʷaɬ
джэдз	d͡ʒad͡z
джэдыгу	d͡ʒadəɡʷ
джэдыпэ	d͡ʒadəpa
джэжьын	d͡ʒaʑən
джэлъын	d͡ʒaɬən
джэлыгъон	d͡ʒaɬəʁʷan
джэмышх	d͡ʒaməʃx
джэн	d͡ʒan
джэнапхъэ	d͡ʒanaːpχa
джэнджэш	d͡ʒand͡ʒaʃ
джэндын	d͡ʒandən
джэнета	d͡ʒanajtaː
джэнчы	d͡ʒant͡ʃə
джэнчыдз	d͡ʒant͡ʃəd͡z
джэныкъохьаку	d͡ʒanəqʷaħaːkʷ
джэныкъу	d͡ʒanəqʷ
джэнэпылъапӏ	d͡ʒanapəɬaːpʼ
джэрыон	d͡ʒarəwan
джэрыуакӏо	d͡ʒarəwaːkʷʼa
джэуап	d͡ʒawaːp
джэущтэу	d͡ʒawɕtaw
джэфы	d͡ʒafə
джэхашъо	d͡ʒaxaːʃʷa
джэщгъум	d͡ʒaɕʁʷəm
дзакӏо	d͡zaːkʷʼa
дзапӏэ	d͡zaːpʼa
дзуцон	d͡zʷət͡sʷan
дзын	d͡zən
дзыо	d͡zəwa
дзэ	d͡za
дзэкӏолӏы	d͡zakʷʼaɬʼə
дзэлыкъуэбгъэ	dzaləqʷabʁa
дзэлӏы	d͡zaɬʼə
дзэпщ	d͡zapɕə
динынчъэ	dənənt͡ʂʼa
дыгьы	dəɡʲə
дыджы	dəd͡ʒə
дыин	dəjən
дый	dəj
дыйдалхь	dəjdaːlħ
дыйдэлъ	dəjdaɬ
дыйрылъ	dəjarəɬ
дыйшъо	dəjʃʷa
дыйшъоутын	dəjʃʷawtən
дыкъын	dəqən
дын	dən
дыо	dəwa
дыргу	dərɡʷ
дырын	dərən
дысы	dəsə
дыу	dəw
дыухьэ	dəwħa
дыухэр	dəwar
дыуэр	dəwar
дыхьэщхын	dəħaɕxən
дышъэ	dəʂa
дышъэкӏ	dəʂat͡ʃ
дышъэчэт	dəʐakʲat
дышъэчэт	dəʐat͡ʃat
дыщыпс	dəɕəps
дэ	da
дэбзыкъу	dabzəqʷ
дэбыбэен	dabəbajan
дэгу	daɡʷə
дэгъналъэ	daʁnaːɬa
дэгъолъхьан	taʁʷaɬħaːn
дэгъу	daʁʷə
дэгъэбыбыкӏын	daʁabəbət͡ʃən
дэгъэбыбэен	daʁabəbajan
дэгъэбылъхьан	daʁabəɬħan
дэгъэбылъхьэн	daʁabəɬħan
дэгъэдыдыкӏын	daʁadədəkʲən
дэгъэзен	daʁazajan
дэгъэзын	daʁazən
дэгъэкӏоен	daʁakʷʼajan
дэгъэнэн	daʁanan
дэгъэптӏэн	daʁaptʼan
дэгъэткӏон	daʁatkʷʼan
дэгъэтын	daʁatən
дэгъэтӏысхьэн	daʁatʼəsħan
дэгъэтӏытӏэн	daʁatʼətʼan
дэгъэуцон	daʁawat͡sʷan
дэгъэфэн	daʁafan
дэгъэчъыхьэн	daʁat͡ʃəħan
дэж	daʒ
дэжь	daʑ
дэзэкӏон	dazakʷʼan
дэи	dajə
дэигъэ	dajəʁa
дэй	daj
дэкон	dakʷan
дэкьэн	dakʲan
дэкӏогъу	dakʷʼaʁʷ
дэкӏоен	dakʷʼajan
дэкӏон	dakʷʼan
дэкӏоцэн	dakʷʼat͡san
дэкӏояпӏэ	dakʷʼajaːpʼa
дэлъхьэн	daɬħan
дэлъын	daɬən
дэлъыпӏэ	daɬəpʼa
дэн	dan
дэнэн	danan
дэон	dawan
дэпкъы	dapqə
дэптӏэн	daptʼan
дэсын	dasən
дэтхъын	datχən
дэтэкъон	dataqʷan
дэтэкъун	dataqʷən
дэуахьы	dawaːħə
дэублэн	dawəbɮan
дэубытэн	dawbətan
дэугощын	dawɡʷaɕən
дэфын	dafən
дэфыцӏэн	dafət͡sʼan
дэфэн	dafan
дэхъун	daχʷən
дэхьагъо	daħaːʁʷa
дэхьан	daħaːn
дэхьапӏэ	daħaːpʼa
дэхьащх	daħaːɕx
дэхьащхын	daħaːɕxən
дэхьыен	daħəjan
дэхьын	daħən
дэхьыхын	daħəxən
дэхьэ	daħa
дэхьэгъу	daħaːʁʷa
дэхьэзэ	daħaza
дэхэт	daxat
дэшхын	daʃxən
дэщтэн	daɕtan
дэщыен	daɕəjan
дэщэн	daɕan
дэялъ	dajaːɬ
дэӏон	daʔʷan
дэӏэпыӏэн	daʔapəʔan
е	ja
ебгъэн	jabʁan
ебгъэчэхын	jabʁat͡ʃaxən
ебгын	jabɣən
ебз	jabz
ебзэин	jabzajən
еблэгъапӏэ	jablaʁaːpʼa
еблэгъэн	jablaʁan
ебэджын	jabad͡ʒən
ебэнын	jabanən
ебэун	bawan
егугъун	jaɡʷəʁʷən
егукӏэн	jaɡʷət͡ʃan
егун	jaɡʷən
егупсэн	jaɡʷəpsan
егупшысэн	jaɡʷəpʃəsan
егъанэ	jaʁaːna
егъашӏи	jaʁaːʃʼəj
егъоин	ʁʷajən
егъуин	jaʁʷəjən
егъэблэгъэн	jaʁablaʁan
егъэбэджын	jaʁabad͡ʒən
егъэджэн	jaʁad͡ʒan
егъэжьапӏэ	jaʁaʑaːpʼa
егъэжьэн	jaʁaʑan
егъэзыгъ	jaʁatəʁ
егъэзын	jaʁatən
егъэкӏун	jaʁakʷʼən
егъэлъэгъун	jaʁaɬaʁʷən
егъэлыен	jaʁaɮəjan
егъэолӏэн	jaʁawaɬʼan
егъэпхыгъ	xaʃʼaːʁ
егъэпхын	jaʁapxən
егъэсэн	jaʁasan
егъэтыгъ	jaʁatəʁ
егъэтын	jaʁatən
егъэуагъ	jaʁawaːʁ
егъэун	jaʁawən
егъэусыен	ʁawsəjan
егъэхын	jaʁaxən
егъэхьын	jaʁaħən
егъэчъэхын	jaʁat͡ʂaxən
егъэӏун	jaʁaʔʷən
егыин	jaɣəjən
егьапӏэ	jaɡʲaːpʼa
егьэн	jaɡʲan
еджакӏо	jad͡ʒaːkʷʼa
еджапӏэ	jad͡ʒaːpʼa
еджыджэхын	jad͡ʒəd͡ʒan
еджэжьын	d͡ʒaʑən
еджэн	jad͡ʒan
еджэнджэшын	jad͡ʒand͡ʒanʃən
едзын	jad͡ʒən
едэхэшӏэн	jadaxaʃʼan
едэӏун	jadaʔʷən
ежь	jaʑ
ежьапӏэ	jaʑaːpʼa
ежьашъо	jaʑaːʂʷa
ежьхэ	jaʑxa
ежьэжьын	jaʑaʑən
ежьэн	jaʑan
ежэн	jaʒan
езбырэу	jazbəraw
езбэрэу	jazbaraw
езэгъын	jazaʁən
езэон	jazawan
езэщын	jazaʃən
еин	jajən
екъудыин	qʷədəjən
екӏолӏэн	jakʷʼaɬʼan
екӏошъэн	jakʷʼaʂan
екӏун	jakʷʼən
екӏуэщэн	jakʷʼaɕan
екӏэхын	jat͡ʃʼaxəm
елбэтэу	jaɮbataw
елъэпэон	jaɬapawan
елэн	jalan
емын	jamən
емынэ	jaməna
енэгуен	janaɡʷəjan
енэгуй	janaɡʷəj
енэгуягъо	janaɡʷəjaːʁʷa
енэкъокъун	janaqʷaqʷan
енэкӏьэон	janakʲawan
енэкӏэон	janat͡ʃawan
енэпэон	napawan
енэпэшъоон	janapaʃʷawan
енэсӏын	janasʼən
енэу	janaw
енэцӏын	janat͡sʼən
еон	jawan
еоой	jawawaj
еплъын	japɬən
епхын	japxən
епцӏыжьын	japt͡sʼəʑən
епщэн	jpɕan
епыгьын	japəɡʲən
епыджын	japəd͡ʒən
епэсын	japasən
епэшӏэн	japaʃʼan
епӏэстхъын	japʼastχən
ерагъ	jaraːʁ
ерагъкӏэ	jaraːʁt͡ʃʼa
ерагъэу	jaraːʁaw
еры	jarə
ерыуадж	jarəwaːd͡ʒ
естылӏэн	jastəɬʼan
есын	jasən
есыпӏэ	jasəpʼa
есэн	jasan
есэпэон	jasapawan
етхъон	jatχʷan
етын	jatən
етӏагъо	jatʼaːʁʷa
етӏагъу	jatʼaːʁʷ
етӏанэ	jatʼaːna
етӏапсӏэ	jatʼaːpt͡sʼa
етӏапцӏэ	jatʼaːpt͡sʼa
етӏуанэ	jatʷʼaːna
етӏупщыхьахын	jatʷʼpɕəħaːxən
етӏэрэхын	jatʼaraxən
етӏэхъун	jatʼaχʷən
еубзэн	jawəbzan
еубын	jawbən
еубэн	jawban
еугъоин	jawəʁʷajən
еуджэгъун	jawd͡ʒaːʁʷən
еузэнкӏын	jawzant͡ʃən
еузэпкъын	jawzapqən
еукӏорэикӏын	jawkʷʼarajət͡ʃʼən
еукӏын	jawət͡ʃʼən
еун	jawən
еупцӏын	jawpt͡sʼən
еупчын	jawpt͡ʃən
еутын	jawtən
еутэкӏын	jawtat͡ʃʼən
еутэкӏьын	jawtakʲʼən
еуцолӏэн	jawt͡ʃʷaɬʼan
ехъонын	jaχʷanən
ехъопсэн	jaχʷapsan
ехъу	jaχʷ
ехъункӏын	jaχʷənt͡ʃən
ехъурэ	jaχʷra
ехъушъутэон	χʷəʂʷtawan
ехъырхъышэн	jaχərχəʃan
ехъырэхъышэн	jaχəraχəʃan
ехын	jaxə
ехьагъушъугъун	jaħaːʁʷəʃʷəʁʷən
ехьыжьэн	jaħəʑan
ецыгъон	jat͡səʁʷan
ецэгъон	jat͡səʁʷan
ецӏэтхъун	jat͡sʼatχʷən
ецӏэшъутэхын	jat͡sʼaʃʷtaxən
ечъэжьэн	jat͡ʂaʑan
ечъэхын	jat͡ʂaxən
ечэнджэшын	jat͡ʃand͡ʒaʃən
ешъокӏу	jaʂʷakʷʼ
ешъон	jaʂʷan
ешъорый	jaʃʷarəj
ешъуакӏо	jaʃʷʼaːkʷʼa
ешъугъон	jaʃʷʁʷən
ешъугъун	jaʃʷʁʷən
ешъукӏын	jaʃʷət͡ʃʼən
ешъухъогъон	jaʃʷəχʷaʁʷan
ешъухъугъон	jaʃʷχʷəʁʷan
ешӏужьын	jaʃʷʼəʑən
ешӏухъогъон	jaʃʷʼəχʷəʁʷan
ешӏэн	jaʃʼan
ещэхын	jaɕaxən
еӏолӏэн	jaʔʷaɬʼan
еӏорышӏэн	jaʔʷarʃʼan
еӏун	jaʔʷən
еӏункӏын	jaʔʷənt͡ʃʼən
еӏункӏэн	jaʔʷənt͡ʃʼən
еӏэзэн	jaʔazan
еӏэн	jaʔan
жабз	ʒabz
жае	ʒaːja
жакъэ	ʒaːqa
жакӏьэ	ʒaːkʲa
жакӏэ	ʒaːtʃʼa
жалэ	ʒaːla
жантӏ	ʒaːntʼ
жашъу	ʒaːʂʷ
жашӏу	ʒaːʃʷʼ
жъабгъо	ʐaːbʁʷa
жъагъ	ʐaːʁ
жъагъэ	ʐaːʁa
жъажъэ	ʐaːʐa
жъалым	ʐaːləm
жъамэ	ʐaːma
жъанч	ʐaːnt͡ʃ
жъапхъэ	ʐaːpχa
жъгъырыу	ʐʁərəw
жъгъэй	ʐʁaj
жъогъобын	ʐʷaʁʷabən
жъогъокӏэкӏахь	ʐʷaʁʷat͡ʃat͡ʃaːħ
жъогъоплӏэн	ʐʷaʁapɬan
жъогъорыплъ	ʐʷaʁʷarəpɬ
жъогъофах	ʐʷaʁʷafaːx
жъогъошӏу	ʐʷaʁʷaʃʷ
жъогъу	ʐʷaʁʷ
жъогъуае	ʐʷaʁʷaːja
жъогъуаплъэ	ʐʷaʁaːpɬa
жъоку	ʐʷakʷ
жъон	ʐʷan
жъонакӏу	ʐʷanaːkʷ
жъоныгъу	ʐʷanəʁʷ
жъоныгъуакӏ	ʐʷanəʁʷaːt͡ʃ
жъоныгъуакӏмаз	ʒʷanəʁʷaːt͡ʃʼmaːz
жъоплъ	ʐʷapɬ
жъопхъу	ʐʷapχʷ
жъоркъ	ʐʷarq
жъоркъы	ʒʷarqə
жъот	ʐʷat
жъотхъу	ʐʷatχʷ
жъотын	ʐʷatən
жъуагъо	ʒʷaːʁʷa
жъуагъэ	ʐʷaːʁa
жъуаф	ʐʷaːf
жъугъ	ʐʷəʁ
жъугъэпащ	ʐʷəʁapaːɕ
жъугъэхэку	ʐʷəʁaxakʷ
жъун	ʐʷən
жъутхэн	maʒʷətxan
жъы	ʐə
жъыгъо	ʐəʁʷa
жъыгъуай	ʐəʁʷaːj
жъыгъэ	ʐəʁa
жъые	ʐəja
жъый	ʐəj
жъыкъат	ʐəqaːt
жъын	ʐən
жъыпӏэ	ʐəpʼa
жъырку	ʐərkʷ
жъыу	ʐəw
жъыуакӏо	ʐəwaːkʷʼa
жъыун	ʐəwən
жъышъо	ʐəʂʷa
жъышъхьэ	ʐəʂħa
жъышъхьэмаф	ʐəʂħamaːf
жъышъхьэмыгъу	ʐəʂħamaəʁʷ
жъыӏо	ʐəʔʷa
жъэбэкъ	ʐabaq
жъэгъуай	ʐaʁʷaj
жъэжъый	ʐaʐəj
жъэжъэн	ʐaʐam
жъэн	ʐan
жъэрым	ʐarəm
жъэу	ʐaw
жыкъузалъ	ʒəqʷəzaːɬ
жын	ʒən
жыфлъат	ʑəfɬaːt
жьао	ʑaːwa
жьау	ʑaːwa
жьаугъуадж	ʑaːwʁʷaːd͡ʒ
жьаушӏ	ʑaːwʃʼ
жьы	ʑə
жьыбгъэ	ʑəbʁa
жьыбгъэос	ʑəbʁawas
жьыгъо	ʑəʁʷa
жьыгъогу	ʑəʁʷaɡʷ
жьыгъэбыб	ʑəʁabəb
жьыгъэбыу	ʑəʁabəw
жьыгъэкъабзэ	ʑəʁaqaːbza
жьыгъэшъуй	ʑəʁaʂʷəj
жьыдзакӏо	ʑəd͡zaːkʷʼa
жьыдзапӏэ	ɕəd͡zəpʼa
жьыдзэ	ʑəd͡zəpʼa
жьызалъ	ʑəzaːɬ
жьызэпеу	ʑəzapajw
жьыкорен	ʑəkʷarajn
жьыкъуз	ʑəqʷəz
жьыкъухь	ʑəqʷəħ
жьыкъыдэгъэкӏын	ʑəqədaʁat͡ʃən
жьыкъэщэн	ʑəqaɕan
жьыкъэщэуз	ʑəqaɕawz
жьын	ʑən
жьынэӏу	ʑənaʔʷ
жьыпэ	ʑəpa
жьырытэдж	ʑərətad͡ʒ
жьыуай	ʑəwaːj
жьыуапӏэ	ʑəwaːpʼa
жьыуз	ʑəwz
жьыф	ʑəf
жьыхъырз	ʑəχərz
жьыхьарз	ʑəħaːrz
жьышъаб	ʑəʂaːb
жьышъхьал	ʑəʂħaːl
жьыщэ	ʑəɕa
жьыӏо	ʑəʔʷa
жьыӏэшӏу	ʑəʔaʃʷʼ
жьэжьын	jaʑaʑən
жьэн	ʑan
жьэу	ʑaw
жэ	ʒa
жэгъу	ʒaʁʷ
жэгъуб	ʒaʁʷəb
жэгъуулал	ʒaʁʷəwlaːl
жэдэзын	ʒadazən
жэдэкон	ʒadakʷan
жэдэкӏэн	ʒadat͡ʃan
жэдэлъхьажьын	ʒadaɬħaːʑən
жэдэлъын	ʒadaxən
жэдэон	ʒadawan
жэдэплъыхьан	ʒadapɬəħaːn
жэдэтэкъон	ʒadazən
жэдэфэн	ʒadafan
жэкъун	ʒaqʷən
жэкӏагъу	ʒat͡ʃaːʁʷ
жэкӏапэ	ʒatʃʼaːpa
жэкӏьапэ	ʒakʲʼaːpa
жэкӏэпэпкъ	ʒatʃʼapapq
жэкӏэпэсыс	ʒat͡ʃapasəs
жэкӏэупс	ʒat͡ʃawps
жэкӏэупсыпӏ	ʒat͡ʃawpsəpʼ
жэкӏэф	ʒat͡ʃaf
жэлъакӏу	ʒaɬaːkʷʼ
жэлый	ʒaləj
жэмай	ʒamaːj
жэмачыу	ʒamaːt͡ʃəw
жэмыӏан	ʒaməʔaːn
жэпкъ	ʒapq
жэпхъэмыбгъу	ʒapχaməbʁʷ
жэрыплъ	ʒarəpɬ
жэрыплъагъ	ʒarəpɬaːʁ
жэрыӏу	ʒarəʔʷ
жэрыӏуабз	ʒarəʔʷaːbz
жэукъ	ʒawq
жэукъыгъ	ʒawqəʁ
жэхъу	ʒaχʷ
жэхъуагъ	ʒaχʷaːʁ
жэхэбэнэн	ʒaxabanən
жэхэзыхьан	ʒaxazəħaːn
жэхэкӏотэн	ʒaxakʷʼatan
жэхэкӏоцэн	ʒaxakʷʼat͡san
жэхэлъэдэн	ʒaxaɬadan
жэхэон	ʒaxawan
жэхэпкӏэн	ʒaxapkʲan
жэхэплъэн	ʒaxapɬan
жэхэпхъэнкӏэн	ʒaxapχant͡ʃan
жэхэтхъон	ʒaxatχʷan
жэхэупцӏэн	ʒaxawpt͡sʼan
жэхэхьан	ʒaxaħan
жэӏонтӏагъ	ʒaʔʷantʼaːʁ
жэӏулэл	ʒaʔʷəlal
жэӏулэлыгъ	ʒaʔʷəlaləʁ
загъорэ	zaːʁʷara
закъу	zaːqʷ
закӏэ	zaːt͡ʃʼa
зандэ	zaːnda
занкӏэ	zaːnt͡ʃa
занкӏэу	zaːnt͡ʃaw
зао	zaːwa
зары	zaːrə
заулэ	zaːwla
зафэ	zaːfa
згъэшъхъын	zʁaʂχən
зегъэуджэгъун	zajəʁawd͡ʒaʁʷən
зегъэун	jaʁawən
зегъэхьын	zajʁaħən
зегъэшъукӏын	zajʁaʃʷət͡ʃʼən
зегъэшӏужьын	zajʁaʃʷʼəʑən
зекӏо	zajkʷʼa
зетын	zajtən
зешъокӏыжьын	zajʃʷat͡ʃʼəʑən
зи	zəj
зифэпэжьыгъ	zəjfapaʑəʁ
зиӏ	zəjʔ
зтэгъэкӏэн	ztaʁat͡ʃan
зупсын	zəwəpsən
зфэӏон	zfaʔʷan
зы	zə
зыб	zəb
зыгокӏэ	zəɡʷarat͡ʃʼa
зыгъэгусэн	zəʁəɡʷəsan
зыгъэнэджэн	zəʁanad͡ʒan
зыгъэпкӏын	zʁapst͡ʃʼən
зыгъэпскӏын	zʁapst͡ʃʼən
зыгъэпсыкӏын	zʁapst͡ʃʼən
зыгъэпсыкӏьын	zʁapskʲən
зыгъэпсэфын	zəʁapsafən
зыгъэсамбырын	zəʁasaːmbərən
зыгъэухьазырын	ħaːzərən
зыгъэшхэкӏын	zəʁaʃxat͡ʃʼən
зыкъэшӏэжьын	zəqaʃʼaʑən
зылӏэжьын	zaːɬʼaʑən
зыохьын	zəwaħən
зыпари	zəpaːrəj
зыплъыхьан	zəpɬəħaːn
зыплъыхьапӏэ	zəpɬəħaːpʼa
зыплъыхьын	zəpɬəħən
зыпэгъотхьажьын	zəpaʁʷatħaʑən
зыпэгъутхьажьын	zəpaʁʷatħaʑən
зыпэгъэплъэн	zəpaʁapɬan
зыпэшӏыжьын	zəpaʃʼəʑən
зытегъэкӏэн	zətajʁat͡ʃʼan
зыушъэфын	zawəʂafən
зыуӏэшын	zəwʔaʃən
зыфэгъэгусэн	zəfaʁaɡʷəsan
зыфэгъэсакъын	zəfaʁasaːqən
зыфэгъэсэн	zəfaʁasan
зыци	zət͡səj
зыцый	zət͡səj
зышъутыпцӏын	zəʃʷətəpsʼən
зышӏоу	zəʃʷʼəw
зышӏошӏужьын	zəʃʷʼəʃʷʼaʑən
зыщыгъэгъупшын	zəɕəʁaʁʷəpʃən
зыщыгъэзыен	zəʃəʁazəjan
зыщыгъэзын	zəɕəʁaʁʷəpʃən
зыщыдзыен	zəɕəd͡zəjan
зыщэӏэн	zəɕaʔan
зыӏуамылъхьажь	zəʔʷaːməɬħaːʑ
зыӏыгъэхьан	zaʔaʁaħaːn
зыӏэгъэхьан	zaʔaʁaħaːn
зыӏэкӏэубытэн	zəʔat͡ʃʼawbətan
зэ	za
зэблэдзын	zabɮad͡zən
зэблэкьын	blapkʲən
зэблэхъун	zaplaχʷən
зэгогъэкӏын	zaɡʷaʁat͡ʃʼən
зэгожъын	zaɡʷaʐən
зэгокӏын	zaɡʷat͡ʃʼən
зэгокӏьын	zaɡʷatkʲʼən
зэгокӏьын	zaɡʷat͡ʃən
зэгоожьын	zaɡʷawaʑən
зэготӏэпӏыкӏын	zaɡʷatʼapʼət͡ʃʼən
зэгоутын	zaɡʷawtən
зэгочын	zaɡʷat͡ʃən
зэгощын	zaɡʷaɕən
зэгу	zaɡʷə
зэгъэлъагъэ	zaʁaɬaːʁa
зэгъэн	zaʁan
зэгъэпэшын	zaʔapaʃən
зэгъэфагъ	zaʁafaːʁ
зэгъэфэгъэн	zaʁafaʁan
зэгъэфэн	zaʁafan
зэгъэшӏэн	zaʁaʃʼan
зэгьэм	zaɡʲam
зэдзэкӏакӏо	zad͡zat͡ʃʼaːkʷʼa
зэдзэкӏакӏу	zad͡zat͡ʃaːkʷʼ
зэдзэкӏын	zad͡zat͡ʃən
зэжъу	zaʐʷə
зэзэгъын	zazaʁən
зэзэон	zazawan
зэйтынчъыг	zajtəntʂəɣ
зэкъодзэн	zaqʷad͡zan
зэкъолъэдагъ	zaqʷaɬadaːʁ
зэкъошныгъ	zaqʷaʃnəʁ
зэкӏон	zakʷʼan
зэкӏэ	zat͡ʃʼa
зэкӏэкӏон	zat͡ʃʼakʷʼan
зэкӏэплъэн	zat͡ʃʼakʷʼan
зэкӏэугъоен	zat͡ʃʼawʁʷawan
зэкӏэхьажьын	zat͡ʃʼaħaːʑən
зэкӏэхьан	zat͡ʂaħan
зэкӏэхьэн	zat͡ʃʼaħan
зэкӏэчъэн	zat͡ʃʼat͡ʂan
зэлъежьэжь	zajɬajʑaʑ
зэмылӏэужыгъу	zaməɬʼawʒəʁʷ
зэндалэ	zandaːla
зэокӏокъуашъу	zawkʷʼaqʷaʂʷə
зэолӏ	zawaɬʼ
зэон	zawan
зэпачъэ	zapaːt͡ʂa
зэпедзын	zapajd͡zən
зэплъэкӏыгъу	zapɬat͡ʃʼəʁʷ
зэплъэкӏын	zapɬat͡ʃʼən
зэплъэхьын	zapɬaħən
зэпыгъэжъэн	zapəʁaʐan
зэпыгъэун	zapəʁawən
зэпыгъэчъын	zapəʁat͡ʂən
зэпыгъэчъыхьан	zapəʁat͡ʂəħaːn
зэпыгъэшхэн	zapəʁaʃxan
зэпыдагъэу	zapədaːʁaw
зэпыдзын	zapəd͡zən
зэпыдэн	zapədan
зэпыкӏын	zapət͡ʃʼən
зэпыкӏьын	zapəkʲʼən
зэпымыурэ	zapəməwra
зэпырыкӏын	zapərət͡ʃʼən
зэпырычъын	zapərət͡ʂən
зэпытхъын	zapətχən
зэпыун	zapəwən
зэпыутын	zapəwtən
зэпычын	zapəkʲən
зэпычын	zapət͡ʃən
зэпэзэдакъ	zapazadaːq
зэпэкӏэкӏын	zapat͡ʃʼat͡ʃʼən
зэпэчъэн	zapat͡ʂan
зэпэчӏэкӏын	zapat͡ʂʼat͡ʃʼən
зэребылэу	zarajbəɮaw
зэрэкъэлъагъорэмкӏэ	zaraqaɬaːʁʷaramt͡ʃʼa
зэтелъхьэн	zatajɬħan
зэтеуцон	zatajwt͡ʃʷan
зэтэлъхьэн	zataɬħan
зэтэлъын	zataɬən
зэтэухьэлэн	zatawħalan
зэтэуӏокӏэн	zatawʔʷat͡ʃʼan
зэтӏэхъужьын	zatʼaχʷəʑən
зэтӏэхъун	zatʼaχʷən
зэуакӏо	zawaːkʷʼa
зэуал	zawaːɮ
зэуалӏ	zawaːɬʼ
зэуапӏэ	zawaːpʼa
зэужэу	zawʒaw
зэутэкӏын	zawtat͡ʃən
зэуэн	zawan
зэфачъэ	zafaːt͡ʂa
зэфэчъэн	zafat͡ʂan
зэфэшӏын	zafaʃʼən
зэхъокӏын	zaχʷat͡ʃʼən
зэхъокӏьын	zaχʷakʲʼən
зэхэгъэтэкъун	zaxaʁataqʷən
зэхэгъэшъухъон	zaxaʁaʃʷəχʷan
зэхэдзын	zaxad͡zən
зэхэдзышъун	zaxad͡zəʃʷən
зэхэкӏын	zaxat͡ʃʼən
зэхэон	qawan
зэхэсыпӏэ	zaxasəpʼa
зэхэтэкъун	zaxataqʷən
зэхэугъоен	zaxawʁʷawan
зэхэутын	zaxawtən
зэхэфэн	zaxafan
зэхэхын	zaxaxən
зэхэшӏыкӏын	zaxaʃʼət͡ʃʼən
зэхэщын	zaxaɕən
зэхэщэн	zaxaɕan
зэчэрые	zakʲarəja
зэчэрые	zat͡ʃarəja
зэшӏожьын	zaʃʷʼəʑən
зэшӏокӏын	zaʃʷʼat͡ʃʼən
зэшӏохын	zaʃʷʼaxən
зэщыгъо	zaɕəʁʷa
зэщыкъон	zaɕəqʷan
зэщын	zaɕən
зэӏукӏапӏэ	zaʔʷət͡ʃʼaːpʼa
зэӏукӏэн	zaʔʷət͡ʃʼan
зэӏунын	zaʔʷənan
зэӏунэн	zaʔʷənan
зэӏупхъон	zaʔʷəpχʷan
зэӏыгъэхьан	zaʔaʁaħan
зэӏыхьан	zaʔaħan
зэӏэгъэхьан	zaʔaʁaħaːn
зэӏэгъэхьэн	zaʔaʁaħan
зэӏэхын	zaʔaxən
зэӏэхьан	zaʔaħan
зэӏэхьэн	zaʔaħan
и	jə
ибэ	jəba
ибэдалэу	jəbadaːlaw
игъоин	jəʁʷajən
игъолъхьан	taʁʷaɬħaːn
игъу	jəʁʷa
игъуадж	jəʁʷaːd͡ʒ
игъэкъугъэ	jəʁaqʷəʁa
игъэсэн	jəʁasan
игъэхъон	əʁaχʷan
иджы	jəd͡ʒə
иджэгъун	d͡ʒaʁʷən
идзэн	jəd͡zan
иен	jajən
изакъу	jəzaːqʷ
изы	jəzə
изын	jəzən
изэу	jəzaw
икъугъэ	jəqʷəʁa
икъун	jəqʷən
икӏодыкӏын	jəkʷʼadət͡ʃʼəm
илъыгъу	jəɬəʁʷ
илъын	jəɬən
илъэдэн	jəɬadan
илъэс	jəɬas
илыягъ	jəɮəjaːʁ
инапэкӏэ	jənaːpat͡ʃʼa
инахэкӏэ	jənaːxat͡ʃʼa
ины	jənə
иныжъ	jənəʐ
ипашъхьэ	jəpaːʂħa
ипхъыхьан	jəpχəħaːn
ипшын	jəpʃən
ипэгъум	jəpaʁʷəm
ипэрэгъум	jəparaʁʷəm
ипэтхьэмафэ	jəpatħamaːfa
исхьэкъ	jəsħaq
исэн	jəsan
итхагъэп	jətxaːʁap
итхъун	jətχʷən
итын	jətən
итэкъохьын	jətaqʷaħən
итэкъун	jətaqʷən
иуж	jəwəʒ
иужым	jəwʒəm
иупкӏын	jəwpt͡ʃʼən
иусыф	jəwsəf
иушӏоин	jəwʃʷajən
ифын	jəfən
ифэн	jəfan
ихьан	jəħaːn
ичэ	jət͡ʃa
ичӏыпӏэкӏэ	jət͡ʂʼəpʼat͡ʃʼa
ишъукӏын	jəʃʷət͡ʃʼn
ишъун	jəʃʷən
ишӏыхьан	jəʃʼəħaːn
ишӏэхьан	jəʃʼaħaːn
иӏэн	jəʔan
ко	kʷa
коил	kʷajəl
кой	kʷaj
койыл	kʷajəl
кокӏ	kʷat͡ʃʼ
коны	kʷanə
копкъ	kʷapq
копкъышъхьэ	kʷapqəʂħa
корт	kʷart
корэн	kʷaran
корэныгу	kʷaranəɡʷ
коц	kʷat͡s
коцы	kʷat͡sə
кощын	kʷaɕən
ку	kʷə
куамэ	kʷaːma
куандэ	kʷaːnfa
куахъо	kʷaːχʷa
куашъо	kʷaːʃʷa
куашъу	kʷaːʃʷa
кугъачъ	kʷəʁaːt͡ʃ
кудэ	kʷəda
кукумау	kʷəkʷmaːw
кукунэгъэбылъ	kʷəkʷnaʁabəɬ
кукунэгъэплъ	kʷəkʷnaʁapɬ
кукуу	kʷəkʷəw
кулъэшъу	kʷəɬaʃʷ
куогъу	kʷəwaʁʷ
куон	kʷəwan
куп	kʷəp
купкӏ	kʷəpt͡ʃʼ
купсэ	kʷapsa
купэ	kʷəpa
курэжъые	kʷəraʐəja
кутлэ	kʷətla
куу	kʷəwə
кухьэ	kʷəħa
куцэ	kʷət͡sa
куцӏы	kʷət͡sʼə
кушъхьэ	kʷəʂħa
кушъхьэфачъэ	kʷəʂħafaːt͡ʂa
кушъэ	kʷəʂa
кущэрэхъ	kʷəɕaraχ
кхъу	qʷə
кхъу	χʷə
къабзэ	qaːbza
къаблэ	qaːbla
къаз	qaːz
къазгъыр	qaːzʁər
къазмакъбзыу	qaːzmaːqbzəw
къазмэ	qaːzma
къаигъэ	qaːjəʁa
къакъыр	qaːqər
къалэ	qaːla
къалэ	qaːɮa
къамзэгу	qaːmzaɡʷ
къамцӏыч	qaːmt͡sʼət͡ʃ
къамыл	qaːməɮ
къамыщ	qaːməɕ
къамэ	qaːma
къангъэбылъ	qaːnʁabəɬ
къаплъэн	qaːpɬan
къапщыкъ	qaːpɕəq
къарыу	qaːrəw
къарыунчъ	qaːrəwənt͡ʂ
къарыунчъэ	qaːrəwənt͡ʂ
къарэ	qaːra
къарэу	qaːraw
къатыр	qaːtər
къаум	qaːwəm
къаунэ	qaːwəna
къахьэуашъо	qaːħawaːʃʷa
къашхъо	qaːʃχʷa
къашъо	qaːʂʷa
къашыкъ	qaːʃəq
къашыкъгъуанэ	qaːʃəqʁʷaːna
къашыкъхъурай	qaːʃəqχʷəraːj
къаӏогъум	qaːkʷʼaʁʷəm
къаӏорэгъум	qaːkʷʼaʁʷəm
къегъоин	qajʁʷajən
къегъэблэгъэн	qajʁablaʁan
къегъэкӏын	qajʁat͡ʃʼən
къегъэтӏыхын	qajʁatʼəxən
къегъэӏыхын	qajʁatʼəxən
къеджэн	qajd͡ʒan
къекӏэхын	qajt͡ʃʼaxəm
къелэлэхын	qajɬaɬaxən
къепщэн	qajpɕan
къетӏэрэхын	qajtʼaraxən
къеулэлэхын	qajɬaɬaxən
къефэхын	qajfaxən
къехьыжьэн	qajħəʑan
къехьэхын	qajħaxən
къехэхьын	qajxaħən
къешхын	qajʃxən
къешӏэн	qajʃʼan
къещыхьэкӏын	qajɕaħat͡ʃʼən
къещэкӏын	qajɕat͡ʃʼən
къикӏын	qəjt͡ʃʼən
къикӏьэсӏын	qəjkʲʼasʼən
къилъын	qəjɬən
къины	qəjnə
къиныгъу	qəjnəʁʷ
къитхъун	qjətχʷən
къиухын	qəjwxən
къихын	qəjxən
къо	qʷa
къогъо	qʷaʁʷa
къоджэгъу	t͡ʃəɮaʁʷ
къожъ	qʷaʐ
къозын	qʷazən
къокъон	qʷaqʷan
къокӏын	qʷat͡ʃʼən
къокӏыпӏэ	qʷat͡ʃʼəpʼa
къокӏьын	qʷakʲʼən
къолагьэ	qʷalaːɡʲa
къоладжэ	qʷalaːd͡ʒa
къолай	qʷalaːj
къолы	qʷalə
къолэбзыу	qʷalabzəw
къолэжъ	qʷalaʐ
къолэн	qʷalan
къолэнсэлэн	qʷalansalan
къонцӏэу	qʷant͡sʼaw
къоны	qʷanə
къопс	qʷaps
къорылъф	qʷarəɬf
къотэгъу	qʷataʁʷ
къоуцон	qʷawt͡ʃʷan
къохь	qʷaħ
къохьан	qʷaħaːn
къохьапӏэ	qʷaħaːpʼ
къохьэн	qʷaħan
къошъобэщ	qʷaʂʷabaɕ
къошъолӏы	qʷaʂʷaɬʼə
къошъомэзэжъый	qʷaʂʷamazaʐəj
къошъофы	qʷaʂʷafə
къошъочӏэгъаз	qʷaʂʷat͡ʃaʁaz
къошъошӏы	qʷaʂʷaʃə
къошын	qʷaʃən
къощыр	qʷaɕər
къоӏус	qʷaʔʷəs
къу	qʷə
къуаджэ	qʷaːd͡ʒa
къуае	qʷaːja
къуалъхьэ	qʷaːɬħa
къуамэ	qʷaːma
къуанчӏэ	qʷaːnt͡ʃa
къуао	qʷaːwa
къуапсӏэ	qʷaːpsʼa
къуапцӏэ	qʷaːpt͡sʼa
къуапэ	qʷaːpa
къуахъо	qʷaːχʷa
къуашъо	qʷaːʂʷa
къуащэ	qʷaːɕa
къуащэу	qʷaːɕaw
къугъо	qʷəʁʷa
къуджыр	qʷəd͡ʒər
къудыин	qʷədəjən
къужъы	qʷəʐə
къузмэзадэ	qʷəzmazaːda
къуй	qʷəj
къул	qʷəɮ
къуладжэ	qʷəɮaːd͡ʒa
къулбастэ	qʷəlbaːsta
къулъфыгъэ	qʷəɬfəʁa
къулыкъу	qʷəɮəqʷ
къумбыл	qʷəmbəɮ
къупышъхьэ	qʷəpəʂħa
къурбычый	qʷərbət͡ʃəj
къурбэкъый	qʷərbaqəj
къурбэкъэй	qʷərbaqaj
къурнэ	qʷərna
къутамэ	qʷətaːma
къутаф	qʷətaːf
къутыр	qʷətər
къутэн	qʷətan
къухьэ	qʷəħa
къухьэбыб	qʷəħabəb
къухьэлъат	qʷəħaɬaːt
къухьэтӏысыпӏ	qʷəħatʼəsəpʼ
къухьэуцупӏэ	qʷəħawt͡sʷəpʼa
къушъу	qʷəʃʷ
къушъхьэ	qʷəʂħa
къуэдэс	qʷadas
къыблэ	qəbla
къыгъэ	qəʁa
къыдэгъэж	qədaʁaʒ
къыдэгъэчъ	qədaʁat͡ʂ
къыдэкӏохьын	qədakʷʼaħən
къыдэкӏухьан	qədakʷʼəħaːn
къыдэмыхъун	qədaməχʷən
къыдэхъун	qədaχʷən
къызбэч	qəzbaːkʲ
къызбэч	qəzbaːt͡ʃ
къызыщылъэтын	qəzəɕəɬatən
къыин	qəjən
къыкъокӏын	qəqʷat͡ʃʼən
къыкӏышын	qət͡ʃəʃən
къылъыкӏотэн	qəɬəkʷʼatan
къын	qən
къыпцӏэ	qəpt͡ʃa
къыпылэлын	qəpəɮaɮən
къыпыун	qəpəwən
къыпыщын	qəpəɕən
къыпэшӏошӏын	qəpaʃʷʼaʃʼən
къырикӏон	qərəjkʷʼan
къытегъэзын	qətajʁazən
къытегъэзэн	qətajʁazan
къытэгъэзэн	qətaʁazan
къыухьан	qəwəħaːn
къыфифэн	qəfəjfan
къыхэущыкӏын	qəxawɕət͡ʃʼən
къыхэущыкӏьын	qəxawɕəkʲʼən
къыцэ	qət͡sa
къычӏэгъэкӏын	qət͡ʃʼaʁakʲʼən
къычӏэгъэкӏьын	qət͡ʃʼaʁakʲʼən
къычӏэгъэщын	qət͡ʂʼaʁaɕən
къычӏэхын	qət͡ʃʼaxən
къычӏэщын	qət͡ʂʼaɕən
къыщыкӏэн	qəɕət͡ʃʼan
къыщынэн	qəɕəwnan
къыщыунэн	qəɕəwnan
къыӏупсын	qəʔʷəpsə
къыӏыхын	qəʔəxən
къыӏэкӏэхьэн	qəʔat͡ʃʼaħaːn
къыӏэпхъотэн	qəʔapχʷatan
къыӏэхын	qəʔaxən
къэ	qa
къэбар	qabaːr
къэбарыпцӏы	qabaːrəpt͡sʼə
къэбаскъэ	qabaːsqa
къэбастхъэ	qabaːstχa
къэбкӏэ	qabkʲʼa
къэблэн	qablan
къэбы	qabə
къэбыпцӏэ	qabəpt͡sa
къэбэкъао	qabaqaːwa
къэбэртай	qabartaːj
къэбэртайбзэ	qabartaːjbza
къэвкъаз	qafqaːz
къэгужъон	qaɡʷəʒʷan
къэгупшысын	qaɡʷəpʃəsən
къэгъагъэ	qaʁaːʁa
къэгъуен	qaʁʷajən
къэгъэгъунэн	qaʁaʁaʁʷənan
къэгъэзэгъу	qaʁazaʁʷ
къэгъэзэн	qaʁazan
къэгъэкӏохьын	qaʁakʷʼaħən
къэгъэкӏэхьын	qaʁat͡ʃaħən
къэгъэлъэгъоны	qaʁaɬaʁʷanə
къэгъэнэжьын	qaʁanaʑən
къэгъэнэн	qaʁanan
къэгъэуцун	qaʁawt͡sʷən
къэгъэучъыӏын	qaʁawtʂəʔən
къэгъэущын	qaʁawɕən
къэгъэфын	qaʁafən
къэгъэхъэн	qaʁaχan
къэгъэхын	qaʁaxən
къэгъэӏун	qaʁaʔʷən
къэжьын	qaʑən
къэи	qajə
къэин	qaqəjən
къэкъун	qaqʷən
къэкъушъун	qaqʷəʃʷən
къэкъыин	qaqəjən
къэкӏожьын	qakʷʼaʑən
къэкӏорэгъэ	qakʷʼaraʁa
къэкӏорэтхьэмафэ	qakʷʼaratħamaːfa
къэкӏохьын	qakʷʼaħən
къэкӏухьан	qakʷʼəħaːn
къэкӏыгъэхэр	qakʲʼəʁaxar
къэкӏыгъэхэр	qat͡ʃʼəʁaxar
къэкӏын	qat͡ʃʼəm
къэлапчъ	qalaːpt͡ʃ
къэлъфын	qaɬfən
къэлъы	qaɬə
къэлыдын	qaɮədən
къэлэдэс	qaɮadas
къэлэм	qalam
къэлэмдалъхьэ	qalamdaːɬħa
къэлэсэраи	qalasaraːjə
къэлэсэрай	qalasaraːj
къэмлан	qamlaːn
къэмэхын	qamaxən
къэнэн	qanan
къэнэхъэжьын	qanaχaʑən
къэон	qawan
къэплъан	qapɬaːn
къэпсын	qapsən
къэпсэн	qapsan
къэптан	qaptaːn
къэпчъын	qapt͡ʂən
къэпшӏэжын	qapʃʼaʑən
къэпшӏэн	qapʃʼan
къэпы	qapə
къэраб	qaraːb
къэрабгъэ	qaraːbʁa
къэрал	qaraːɮ
къэралыгъу	qaraːɮəʁʷ
къэркъэтэн	qarqatan
къэрэбгъэ	qarabʁa
къэрэгъул	qaraʁʷəl
къэрэу	qaraw
къэсшъхьэпкӏьэтын	qasʂħapkʲʼatən
къэсшъхьэпкӏэтын	qasʂħapkʲʼatən
къэсын	qasən
къэсэхын	qasaxən
къэсӏын	sʼən
къэугупшысын	qawɡʷəpʃəsən
къэугъоин	qawʁʷajən
къэун	qawən
къэунэ	qawəna
къэутхын	qawətxən
къэучъыӏын	qawtʂəʔən
къэущын	qapɕən
къэфын	qafən
къэхалъэ	qaxaːɬa
къэхъун	qaχʷən
къэхъушъун	qaχʷəʃʷən
къэхын	qaxən
къэхьо	qaħwa
къэхьпэ	qaħpa
къэхьуашъо	qaħwaːʂʷa
къэхьын	qaħən
къэхьыо	qaħwa
къэхьыпакъо	qaħəpaːqʷa
къэхьыпэ	qaħəpa
къэхьыпэрылъф	qaħəparəɬf
къэхьыуашъо	qaħwaːʂʷa
къэц	qat͡s
къэцы	qat͡sə
къэцыгъуан	qat͡səʁʷaːn
къэцӏын	t͡sʼən
къэцӏыон	qat͡sʼəwan
къэцӏэтхын	qat͡sʼatxən
къэшъон	qaʂʷan
къэшъуакӏо	qaʃʷaːkʷʼa
къэшӏэжын	qaʃʼaʑən
къэшӏэжьын	qaʃʼan
къэшӏэн	qaʃʼan
къэщыпын	qaɕəpən
къэщэгъу	qaɕaʁʷ
къэщэкьын	qaɕakʲən
къэщэн	qaɕan
къэщэчын	qaɕat͡ʃən
кьэ	kʲa
кьэпчъэӏу	kʲapt͡ʂaʔʷ
кьэрхъон	kʲarχʷan
кьэт	kʲat
кьэтжъые	kʲatʐəj
кьэтхъэн	kʲʼatχan
кьэтыу	kʲatəw
кьэупчъэ	kʲawəpt͡ʂa
кьэфы	kʲafə
кӏадзэ	t͡ʃʼaːd͡za
кӏай	t͡ʃʼaːj
кӏако	t͡ʃʼaːkʷa
кӏакӏо	t͡ʃaːkʷʼa
кӏакӏы	kʲaːt͡ʃə
кӏакӏы	t͡ʃaːt͡ʃə
кӏалэ	t͡ʃʼaːla
кӏалэ	t͡ʃʼaːɮa
кӏапсэ	t͡ʃʼaːpsa
кӏапсэрыкӏо	t͡ʃʼaːpsarəkʷʼa
кӏапэ	kʲaːpa
кӏапэ	t͡ʃaːpa
кӏасэ	t͡ʃʼaːsa
кӏашъо	t͡ʃʼaːʃʷa
кӏежьэжьын	ʔʷarəʃʼa
кӏодыгъошӏу	kʷʼadəʁʷaʃʷʼ
кӏодыжьыгъошӏу	kʷʼadəʑəʁʷaʃʷʼ
кӏодын	kʷʼadən
кӏожьын	kʷʼaʑən
кӏолӏэн	jakʷʼaɬʼan
кӏон	kʷʼan
кӏосэн	kʷʼasan
кӏотэн	kʷʼatan
кӏохъун	kʷʼaχʷən
кӏоцӏы	kʷʼat͡sʼə
кӏоцӏылъхьэн	kʷʼat͡sʼəɬħan
кӏоцӏыхьан	kʷʼat͡sʼəħaːn
кӏоцӏыщыхьан	kʷʼat͡sʼəɕəħaːn
кӏоцӏыщыхьэн	kʷʼat͡sʼəɕəħan
кӏочӏагъэ	kʷʼat͡ʃʼaːʁa
кӏочӏадж	kʷʼaːt͡ʂʼaːd͡ʒ
кӏошъэн	kʷʼaʂan
кӏошын	kʷʼaʃən
кӏуадж	kʷʼaːd͡ʒ
кӏуапӏэ	kʷʼaːpʼa
кӏуачӏэ	kʷʼaːt͡ʃʼa
кӏун	kʷʼən
кӏурэжъый	kʷʼəraʐəj
кӏуснэщаб	kʷʼəsnaɕaːb
кӏыб	t͡ʃʼəb
кӏыгъун	t͡ʃʼəʁʷən
кӏыин	mat͡ʃʼəjən
кӏыкӏьай	t͡ʃəkʲaːj
кӏымафэ	t͡ʃʼəmaːfa
кӏын	t͡ʃʼən
кӏырыун	t͡ʃʼərəwən
кӏыфы	t͡ʃʼəfə
кӏыхьэ	t͡ʃʼəħa
кӏыхьэлыхьэ	t͡ʃʼəħaɮəħa
кӏышъоӏот	t͡ʃʼəʃʷaʔʷat
кӏышъу	t͡ʃəʂʷ
кӏыӏу	t͡ʃʼəʔʷ
кӏьако	kʲʼaːkʷa
кӏьакӏьэ	kʲʼaːkʲʼa
кӏьапсэ	kʲʼaːpsa
кӏьасэ	kʲʼaːsa
кӏьашъо	kʲʼaːʃʷa
кӏьыин	kʲʼəjən
кӏьэ	kʲʼa
кӏьэй	kʲʼaj
кӏьэлъыон	kʲʼaɬəwən
кӏьэлъыун	kʲʼaɬəwən
кӏьэмгуе	kʲʼamɡʷəja
кӏьэнлъэ	kʲʼanɬa
кӏьэрахъо	kʲʼaraːχʷa
кӏьэрыт	kʲʼarət
кӏьэхьы	kʲʼaħə
кӏьэхьылэхь	kʲʼaħəlaħ
кӏэ	kʼa
кӏэ	t͡ʃʼa
кӏэгъожьын	t͡ʃaʁʷaʑən
кӏэгъэгъожьын	t͡ʃʼaʁaʁʷaʑən
кӏэгъэкӏын	t͡ʃʼaʁat͡ʃʼən
кӏэгьэн	t͡ʃʼaɡʲan
кӏэджэн	t͡ʃʼad͡ʒan
кӏэдзапӏэ	wəbɮaːpʼa
кӏэдэн	t͡ʃʼadan
кӏэегъулъын	t͡ʃʼajaʁʷəɬən
кӏэен	t͡ʃʼajan
кӏэзэзын	t͡ʃʼazazən
кӏэй	t͡ʃʼaj
кӏэкъэпс	t͡ʃaqaps
кӏэкӏьащын	t͡ʃʼakʲʼaːɕən
кӏэлъыкӏон	t͡ʃaɬəkʷʼan
кӏэлъыон	t͡ʃʼaɬəwən
кӏэлъыун	t͡ʃʼaɬəwən
кӏэлъэтэкьын	t͡ʃaɬatakʲən
кӏэлъэӏун	t͡ʃʼaɬaʔʷən
кӏэлэ	t͡ʃala
кӏэлэгъу	t͡ʃalaʁʷ
кӏэлэегъагь	t͡ʃʼalaʁaːɡʲ
кӏэлэегъадж	t͡ʃʼaɮaʁaːd͡ʒ
кӏэлэегьакӏо	t͡ʃʼalajaɡʲaːkʷʼa
кӏэлэеджакӏо	t͡ʃʼaɮajad͡ʒaːkʷʼa
кӏэлэхъу	t͡ʃʼaɮaχʷ
кӏэлэхъуцӏыкӏу	t͡ʃʼaɮaχʷt͡sʼəkʷʼ
кӏэмгуе	t͡ʃʼamɡʷəja
кӏэн	t͡ʃʼan
кӏэнкӏэ	t͡ʃʼant͡ʃʼa
кӏэнкӏэжъапхъэ	t͡ʃant͡ʃaʐaːpχa
кӏэнлъэ	t͡ʃʼanɬa
кӏэнэкӏэн	t͡ʃʼanat͡ʃʼan
кӏэп	t͡ʃʼap
кӏэпхъ	t͡ʃʼapχ
кӏэпхын	t͡ʃʼapxən
кӏэпщ	t͡ʃʼapɕ
кӏэпщы	t͡ʃʼapɕə
кӏэпы	t͡ʃʼapə
кӏэракӏ	t͡ʃʼaraːt͡ʃʼ
кӏэрахъо	t͡ʃʼaraːχʷa
кӏэрхъон	t͡ʃʼarχʷan
кӏэрыкӏэу	t͡ʃʼarət͡ʃʼaw
кӏэрэон	t͡ʃʼarawan
кӏэрэхъоцыкӏу	t͡ʃaraχʷat͡səkʷʼ
кӏэсэн	t͡ʃʼasan
кӏэтал	kʲʼataːl
кӏэтал	t͡ʃʼataːl
кӏэтхъун	t͡ʃʼatχʷən
кӏэтыку	t͡ʃʼatəkʷ
кӏэтыл	t͡ʃʼatəl
кӏэтыщх	kʲatəɕx
кӏэтыщх	t͡ʃatəɕx
кӏэтӏэй	t͡ʃatʼaj
кӏэупкӏэн	t͡ʃʼawpt͡ʃʼan
кӏэупхъухьан	t͡ʃawpχʷəħaːn
кӏэух	t͡ʃʼawəx
кӏэхьан	t͡ʃʼəħaːn
кӏэхьы	t͡ʃʼaħə
кӏэхэкӏын	t͡ʃaxat͡ʃən
кӏэшъун	t͡ʃʼaʃʷən
кӏэшӏыхьан	t͡ʃʼaʃʼəħaːn
кӏэшӏэн	t͡ʃʼaʃʼan
кӏэщакӏо	t͡ʃaɕaːkʷʼa
кӏэӏэжьын	t͡ʃʼaʔaʑən
кӏэӏэн	t͡ʃʼaʔan
лагъымэ	ɮaːʁəma
лагъэ	laːʁa
лажьэ	ɮaːʑa
лалэ	laːla
лантӏэ	laːntʼa
ланчъэ	laːnt͡ʃa
лачэ	laːt͡ʃa
лъабжъэ	ɬaːbʐa
лъагъо	ɬaːʁʷa
лъагэ	ɬaːɣa
лъакъо	ɬaːqʷa
лъапсэ	ɬaːpsa
лъапсӏэ	ɬaːpsʼa
лъапцӏэ	ɬaːpt͡sʼa
лъапэ	ɬaːpa
лъапӏэ	ɬaːpʼa
лъасэ	ɬaːsa
лъашъхьэ	ɬaːʂħa
лъащэ	ɬaːɕa
лъежьэн	ɬajʑan
лъежэн	ɬajʒan
лъфащэ	ɬfaːɕa
лъфыгъэ	ɬfəʁa
лъфын	ɬfən
лъфэн	ɬfan
лъхъанчэ	ɬχaːnt͡ʃa
лъы	ɬə
лъыгъачъэ	ɬəʁaːt͡ʂa
лъыкӏон	ɬəkʷʼan
лъыкӏотэн	ɬəkʷʼatan
лъыкӏошъэн	ɬəkʷʼaʂan
лъын	ɬən
лъынтфэ	ɬəntfa
лъынэ	ɬəna
лъыплъэн	ɬəpɬan
лъытфэ	ɬətfa
лъытэн	ɬətan
лъытэныгъ	ɬətanəʁ
лъыфыгъэ	ɬfəʁa
лъыхъожьын	ɬəχʷaʑən
лъыхъуакӏо	ɬəχʷaːkʷʼa
лъыхъун	ɬəχʷən
лъычъэн	ɬət͡ʂan
лъышӏэжь	ɬəʃʼaʑ
лъышӏэжьакӏо	ɬəʃʼaʑaːkʷʼa
лъышӏэжьын	ɬəʃʼaʑən
лъыӏэбэн	ɬəʔaban
лъыӏэсын	ɬəʔasən
лъэ	ɬa
лъэбакъу	ɬabaːqʷ
лъэбанэ	ɬabaːna
лъэбжъанэ	ɬapʐaːna
лъэбыӏу	ɬabəʔʷ
лъэбэкъу	ɬabaqʷ
лъэгонджэмышъхьэ	ɬaɡʷand͡ʒaməʂħa
лъэгу	ɬaɡʷ
лъэгуаджэ	ɬaɡʷaːd͡ʒa
лъэгуанджэ	ɬaɡʷaːnd͡ʒa
лъэгуц	ɬaɡʷət͡s
лъэгъуае	ɬaʁʷaːja
лъэгъуен	ɬaʁʷəjan
лъэгъун	pɬaʁʷən
лъэгъупхъ	ɬaʁʷəpχ
лъэдакъэ	ɬadaːqa
лъэецуакъо	ɬajat͡sʷaːqʷa
лъэжъуагъ	ɬaʐʷaːʁ
лъэкур	ɬakʷər
лъэкъопцӏанэ	ɬaqʷapt͡sʼaːna
лъэкъорыгъачъэ	ɬaqʷarəʁaːt͡ʂa
лъэкъуапсӏ	ɬaqʷaːpsʼ
лъэкъуапцӏ	ɬaqʷaːpt͡sʼ
лъэкъуасӏэ	ɬaqʷaːsʼa
лъэкъуацӏэ	ɬaqʷaːt͡sʼa
лъэкӏ	ɬat͡ʃʼn
лъэкӏапӏ	ɬat͡ʃaːpʼa
лъэкӏапӏэ	ɬat͡ʃaːpʼ
лъэкӏоцӏ	ɬakʷʼat͡sʼ
лъэкӏын	ɬakʲʼən
лъэкӏын	ɬat͡ʃʼən
лъэкӏэн	ɬat͡ʃan
лъэкӏэпӏащ	ɬat͡ʃʼapʼaːɕ
лъэмыдж	ɬaməd͡ʒ
лъэн	ɬan
лъэныкъу	ɬanəqʷ
лъэныкъуащ	ɬanəqʷaːɕ
лъэой	ɬawaj
лъэпапцӏэ	ɬapaːpt͡sʼa
лъэпкъ	ɬapq
лъэпкъгъэкӏод	ɬapqʁakʷʼad
лъэпкъэгъу	ɬapq
лъэпс	ɬaps
лъэпхъабэ	ɬapχaːba
лъэпщ	ɬapɕ
лъэпщ	ɬapʃʷ
лъэпэд	ɬapad
лъэпэон	ɬapawan
лъэпэпсӏий	ɬapapsʼəj
лъэпӏаӏо	ɬapʼaːʔʷa
лъэрыгъачъэ	ɬarəʁaːt͡ʂa
лъэрымыхь	ɬarəməħ
лъэрычъ	ɬarət͡ʂ
лъэсы	ɬasə
лъэсыбэщ	ɬasəbaɕ
лъэтэн	ɬatan
лъэу	ɬaw
лъэубакъу	ɬawbaːqʷ
лъэугъуае	ɬawʁʷaːja
лъэуж	ɬawəʒ
лъэужь	ɬawəʑ
лъэужьэу	ɬawʑəməj
лъэхъан	ɬaχaːn
лъэхъаны	ɬaχaːnə
лъэхъомбэшх	ɬaχʷambaʃx
лъэхъуамбэ	ɬaχʷaːmba
лъэхъэн	ɬaχan
лъэхьэ	ɬaħa
лъэхэнэн	ɬaxanan
лъэш	ɬaʃ
лъэшъун	ɬaʃʷən
лъэшы	ɬaʃə
лъэшыдж	ɬaʃəd͡ʒ
лъэшыӏо	ɬaʃəʔʷa
лъэшэу	ɬaʃaw
лъэӏуакӏо	ɬaʔʷaːkʷʼa
лы	lə
лы	ɮə
лыгъон	ɮəʁʷan
лыджын	maləd͡ʒən
лыдын	ɮədən
лые	ɮəja
лыкъумэ	ləqʷma
лымышх	ləməʃx
лыпцэ	ləpt͡sa
лыпцӏэ	ləpt͡sʼa
лыргъужъ	lərʁʷəʐ
лышъутӏэ	ləʃʷtʼa
лэблэбый	lablabəj
лэгъу	laʁʷ
лэгъунэ	ɮaʁʷna
лэгъуп	laʁʷəp
лэгьэн	ɮaɡʲan
лэджэн	ɮad͡ʒan
лэжьакӏу	laʑaːkʷʼ
лэжьын	ɮaʑən
лэжьэн	laʑan
лэлэн	lalan
лэн	lan
лэн	ɮan
лэныстэ	lanəsta
лӏакъо	ɬʼaːqʷa
лӏапӏэ	ɬʼaːpʼa
лӏы	ɬʼə
лӏыблан	ɬʼəbɮaːn
лӏыгъэ	ɬʼəʁa
лӏыгъэкӏэ	ɬʼəʁat͡ʃʼa
лӏыжъы	ɬʼəʐə
лӏыжъыгъу	ɬʼəʐəʁʷ
лӏыжъыпӏ	ɬʼəʐəpʼ
лӏыжъышъ	ɬʼəʐəʂ
лӏыкӏо	ɬʼəkʷʼa
лӏымыш	ɬʼəməʃ
лӏыукӏ	maχaːd͡ʒa
лӏыхъу	ɬʼəχʷ
лӏыхъужъ	ɬʼəχʷəʐ
лӏышъхьэ	ɬʼəʂħa
лӏэгъу	ɬʼaʁʷ
лӏэгъуаб	ɬʼaʁʷaːb
лӏэкъолъэш	ɬaqʷaɬaʃ
лӏэкъуацӏэ	ɬʼaqʷaːt͡sʼa
лӏэн	ɬʼan
лӏэу	ɬʼaw
лӏэуж	ɬʼawəʒ
лӏэужыгъо	ɬʼawʒəʁʷa
лӏэужьыгъо	ɬʼawʑəʁʷa
мажьэ	maːʑa
мазэ	maːza
маис	maːjəs
майтэ	maːjta
макъэ	maːqa
макӏэ	maːt͡ʃa
малхъо	maːlχʷa
малъхъо	maːɬχʷa
мамыщ	aːfə
манэ	maːna
мастэ	maːsta
матхъэжьын	maːtχaʑən
матэ	maːta
мафэ	maːfa
махълъэ	maːχɬa
махъсымэ	maːχsəma
махъушэ	maːχʷəʃa
махъушэбзу	maːχʷʃabzəw
махъушэчэтыу	maːχʷəʃakʲatəw
махъушэчэтыу	maːχʷəʃat͡ʃatəw
махъчэ	maːχt͡ʃa
махъчэбзу	maːχt͡ʃabzəw
махъшэбзу	maːχt͡ʃabzəw
махъэ	maːχa
махь	maːħ
махэ	maːxa
мацӏэ	maːt͡sʼa
машинэ	maːʃəna
машэ	maːʃa
машӏо	maːʃʷʼa
маӏьэ	maːʔʲa
модэ	mawda
мусэ	məwsa
мы	mə
мыгъо	məʁʷa
мыгъэ	maʁa
мыгьыр	məɡʲər
мыджыр	məd͡ʒər
мыдэ	məda
мые	məja
мыжъо	məʐʷa
мыжъодэбыш	məʐʷadaməʃ
мыжъокӏашъхъ	məʐʷakʲaːʂχ
мыжъуакӏэ	məʐʷaːt͡ʃa
мызуэ	məʒʷa
мыкӏэ	mət͡ʃʼa
мылъку	məɬəkʷ
мылъфыкъо	məɬfəqʷa
мылъыку	məɬəkʷ
мылы	məɮə
мынэрылъэгъу	mənarəɬaʁʷ
мыпытэ	məpəta
мыскъар	məsqaːr
мыст	məst
мысэ	məsa
мытэрэз	mətaraz
мыхъатэ	məχaːta
мыхъомышӏ	məχʷaməʃʼ
мыхъумыбз	məχʷəməbz
мыхьэнэ	məħana
мычӏы	mət͡ʃə
мышкӏу	məʃkʷ
мышъыпкъэ	məʂəpqa
мышъэ	məʂa
мыщгъум	məɕʁʷəm
мыщыгъу	məɕəʁʷ
мыӏуш	məʔʷəʃ
мыӏэрыс	məʔarəs
мыӏэрысэпсы	məʔarəsapsə
мэ	ma
мэбзэен	mabzajan
мэбзэин	mabzajən
мэбыбын	mabəbən
мэбэгъон	mabaʁʷan
мэбэнэн	mabanan
мэгоӏэн	maɡʷaʔan
мэгубжын	maɡʷəbʒən
мэгушӏон	maɡʷəʃʷʼan
мэгущыӏэн	maɡʷɕəʔan
мэгънэнэн	maʁnanan
мэгъолъын	maʁʷaɬən
мэгъуен	maʁʷəjan
мэгъун	maʁʷən
мэгъушъыжъын	maʁʷʂəʐən
мэгъушъын	maʁʷʂən
мэгъын	maʁən
мэгъэгъэн	maʁaʁan
мэджыджэн	mad͡ʒəd͡ʒan
мэджэгун	mad͡ʒaɡʷən
мэдрэ	madra
мэдрэр	madra
мэдэӏон	madaʔʷan
мэжъутхэн	maʒʷətxan
мэз	maz
мэзагъо	mazaːʁʷa
мэзай	mazaːj
мэзахэ	mazaːxa
мэзгуащэ	mazɡʷaːɕa
мэзкьэт	mazkʲat
мэзпчэн	mazpt͡ʃan
мэзчэт	mazt͡ʃat
мэзчэтыу	mazkʲatəw
мэзчэтыу	mazt͡ʃatəw
мэзы	mazə
мэзыкъу	mazəqʷ
мэзыпчэн	mazəpt͡ʃan
мэзытхьэ	mazətħa
мэзэбэлыдж	mazabaləd͡ʒ
мэзэгъэн	mazaʁan
мэзэзэн	mazazan
мэзэкӏон	zakʷʼan
мэзэон	mazawan
мэкуон	məkʷəwan
мэкъамэ	maqaːma
мэкъу	maqʷ
мэкъумэщышӏ	maqʷmaɕəʃʼ
мэкъуогъумаз	maqʷəwaʁʷəmaːz
мэкъупӏ	maqʷpʼ
мэкъын	maqən
мэкъэкъащ	maqaqaːɕ
мэкъэркъэтэн	maqarqatan
мэкьэн	makʲan
мэкьэрэзын	makʲarazən
мэкӏодын	makʷʼadən
мэкӏосэн	makʷʼasan
мэкӏошъэн	makʷʼaʂan
мэкӏыин	mat͡ʃʼəjən
мэкӏьыин	makʲʼəjən
мэкӏэтхъэн	mat͡ʃatχan
мэл	mal
мэлахъо	malaːχʷa
мэлхъогъ	malχʷaʁ
мэлъэхъу	maɬaχʷ
мэлы	maɮə
мэлыгьын	maləɡʲən
мэлыджын	maləd͡ʒən
мэлыл	maləl
мэлылъфэгъумаз	maləɬfaʁʷəmaːz
мэлыхъогъу	maɮəχʷaʁʷ
мэлэкӏэн	malat͡ʃan
мэлэлэн	malalan
мэлӏэн	maɬʼan
мэмэхъэшэн	mamaχaʃan
мэмэхын	mamaxən
мэнэкъокъон	manaqʷaqʷan
мэон	mawan
мэпкӏэн	mapt͡ʃʼan
мэплъын	mapɬən
мэплъэн	mapɬən
мэпрэзэн	maprazan
мэпсэлъэн	mapsaɬan
мэпхъэпхъэн	mapχapχan
мэпцӏын	mapt͡sʼən
мэпшъын	mapʂən
мэпщын	mapɕən
мэпщэн	mapɕan
мэпыгьэн	mapəɡʲan
мэпыджэн	mapəd͡ʒən
мэпӏэркӏьын	mapʼarkʲən
мэпӏэстхъэн	pʼasχan
мэр	mar
мэракӏуапцӏэ	maraːkʷʼaːt͡sʼa
мэрсысын	marsəsən
мэстын	mastən
мэсэкъатын	masaqaːtən
мэсэн	masan
мэсӏын	sʼən
мэсӏэсӏэн	masʼasʼan
мэтазэ	mataːza
мэткӏун	matkʷʼən
мэтхъэжьын	matχaʑən
мэтхытхын	matxətxən
мэтхьаусхэн	matħaːwəsxan
мэтхэн	matxan
мэтэкхъуайэ	mataqʷaːja
мэтэкхъуайэ	mataχʷaːja
мэтэкъон	mataqʷan
мэтэн	matan
мэтӏатӏэ	matʼaːtʼa
мэтӏыгъо	matəʁʷa
мэтӏыгъон	mətʼəʁʷam
мэтӏэрэхьын	matʼaraħən
мэтӏэтӏэн	matʼatʼan
мэу	maw
мэубэн	mawban
мэубэтэн	mawəbatan
мэузын	mawzən
мэукӏын	mawt͡ʃʼən
мэукӏытэн	mawt͡ʃətan
мэулъыен	mawəɬəjan
мэулэлэн	mawəlalan
мэунэзэн	mawnazan
мэунэхъун	mawnaχʷʁn
мэутэшъон	wtaʃʷan
мэутӏэтӏэн	wətʼatʼan
мэухын	mawxən
мэуцун	mawt͡sʷən
мэуцӏэлэн	mawt͡sʼalan
мэушъы	mawʂə
мэушӏоин	mawʂʷajən
мэуэн	mawan
мэуӏэн	mawʔan
мэфэзакъу	mafazaːqʷ
мэфэку	mafakʷ
мэфэкӏ	mafatʃʼ
мэфэл	mafaɮ
мэхагъ	maxaːʁ
мэхапӏэ	maxaːpʼa
мэхъагьэ	maχaːɡʲa
мэхъаджэ	maχaːd͡ʒa
мэхъужьын	maχʷəʑən
мэхъун	χʷən
мэхъут	maχʷət
мэхъшэбзыу	maχt͡ʃabzəw
мэхъыен	maχəjan
мэхъэшэн	maχaʃan
мэхын	maxən
мэхьанэ	maħaːna
мэхэр	maxar
мэцохъон	mat͡sʷaχʷan
мэцыгъон	mat͡səʁʷan
мэцӏын	mat͡sʼən
мэцӏыон	mat͡sʼəwan
мэцӏыцӏын	mat͡sʼət͡sʼən
мэцӏэлъэн	mat͡sʼaɬan
мэцӏэтхъун	mat͡sʼatχʷən
мэцӏэтхын	mat͡sʼatxən
мэцӏэцӏэн	mat͡sʼat͡sʼan
мэцӏэшъутэн	mat͡sʼaʃʷtan
мэчъыен	mat͡ʃəjan
мэчъэн	mat͡ʂan
мэчэн	mat͡ʃan
мэчэрэгъун	mat͡ʃaraʁʷən
мэчэрэзын	mat͡ʃarazən
мэшто	maʃtəw
мэшто	məʃtəw
мэшъуен	maʃʷəjan
мэшъутырэхьын	maʃʷtəraħən
мэшъухъогъон	ʃʷəχʷaʁʷan
мэшъухъугъон	maʃʷχʷəʁʷan
мэшӏоку	maʃʷʼakʷ
мэшӏотхъуабз	maʃʷʼatχəaːbz
мэшӏощыхъу	sərnət͡ʃ
мэшӏоӏун	maʃʷʼaʔʷən
мэшӏуач	maʃʷʼaːt͡ʃ
мэшӏуащэ	maʃʷʼaːɕa
мэшӏухъогъон	maʃʷʼəχʷəʁʷan
мэшӏыкӏьэен	maʃʼəkʲʼajan
мэшӏыкӏэен	maʃʼət͡ʃʼajan
мэщтын	maqən
мэщтэн	maɕtan
мэщы	maɕ
мэщынэн	maɕənan
набгъу	naːbʁʷə
набгъэ	naːbʁa
назэ	naːza
накӏэ	naːt͡ʃʼa
налкъут	naːlqʷət
налъэ	naːɬa
налэ	naːla
нану	naːnəw
наныу	naːnəw
нао	naːwa
напсэ	naːpsa
напцэ	naːpt͡sa
напэ	naːpa
нарт	naːrt
нарэ	naːra
насып	naːsəp
насыпынчъ	naːsəpənt͡ʂ
насыпынчъэ	naːsəpənt͡ʂ
нат	naːt
натрыф	naːtrəf
натыф	naːtəf
натӏэ	naːtʼa
нафэ	naːfa
нахъутэ	naːχʷta
нахь	naːħ
нахьиу	naːħjəw
нахьыбэрэ	naːħəbara
нахьыбэрэм	naːħəbaram
нахьышӏу	naːħəʃʷʼ
нахэ	naːxa
нацэӏуцэ	natsaʔʷtsa
нашхъо	naːʃχʷa
нашъухъо	naːʂʷχʷa
нашэ	naːʃa
непэ	najpa
нет	najt
неущымыкӏ	najwɕəmət͡ʃʼ
нухь	nəwħ
ны	nə
ныбачъ	nəbaːt͡ʂ
ныбгъу	nəbʁʷə
ныбгъэ	nəbʁa
ныбгъэшъу	nəbʁaʂʷ
ныбджэгъу	nəbd͡ʒaʁʷ
ныбжь	nəbʑ
ныбжьи	nəbʑə
ныбжьыкъу	nəbʑəqʷ
ныбжьыкӏэ	nəbʑət͡ʃʼa
ныбжьэгъу	nəbʑaʁʷ
ныбыдж	nəbəd͡ʒ
ныбэ	nəba
ныбэрый	nəbarəj
ныбэузы	nəbawəzə
ныбэшъу	nəbaʃʷ
ныджы	nəd͡ʒə
ныкъо	nəqʷa
ныкъолӏагъэ	nəqʷaɬʼaːʁa
ныкъуалӏэ	nəqʷaːɬʼa
нынэпӏос	nənapʷʼas
нынэпӏэс	nənapʼas
ныо	nəwa
ныожъ	nəwaʐ
нып	nəp
ныпчыхьэ	nəpt͡ʃəħa
ныпчэдыжьы	nəpt͡ʃadəʑə
нысащэ	nəsaːɕa
нысхъапэ	nəsχaːpa
нысэ	nəsa
нысэпхъапэ	nəsapχaːpa
нычэпэ	nət͡ʃapa
ныӏэ	nəʔa
ныӏэп	nəʔap
нэбгъэ	nabʁa
нэбгы	nabɣə
нэбгыр	nabɣər
нэбзый	nabzəj
нэбзыц	nabzət͡s
нэгу	naɡʷ
нэгушъо	naɡʷəʃʷa
нэгушъоутын	naɡʷəʃʷawtən
нэгушӏу	naɡʷəʃʷʼ
нэгъунджэ	naʁʷənd͡ʒa
нэгъургьэ	naʁʷərɡʲa
нэгъуцу	naʁʷət͡ʃʷ
нэгъучӏыц	naʁʷt͡ʂʼət͡sa
нэгъучӏыцэ	naʁʷt͡ʂʼət͡sa
нэгъэцӏу	naʁat͡sʼəw
нэгъэцӏыу	naʁat͡sʼəw
нэдэлъфыбзэ	nadaɬfəbza
нэз	nazə
нэзы	nazə
нэзэжъу	nazaʒʷ
нэкулъ	nakʷəɬ
нэкъокъон	naqʷaqʷan
нэкъыгъэ	naqəʁa
нэкьыхьытх	nakʲəħətx
нэкӏап	nat͡ʃʼaːp
нэкӏо	nakʷʼa
нэкӏубгъу	nakʷʼbʁʷ
нэкӏушъу	nakʷʼəʂʷ
нэкӏушъхь	nakʷʼəʂħ
нэкӏы	nat͡ʃʼə
нэкӏын	nat͡ʃʼən
нэкӏышъо	nakʼəʃʷa
нэкӏьышъо	nakʼəʃʷa
нэкӏьэон	nakʲʼawan
нэкӏэбыдз	nakʲʼabəd͡z
нэкӏэон	nat͡ʃʼawan
нэмаздэкъ	namaːzdaq
нэмазэ	namaːza
нэмкӏ	namt͡ʃʼ
нэмкӏыр	namt͡ʃʼər
нэмыкӏ	namət͡ʃʼ
нэмыкӏыр	namət͡ʃʼər
нэмысыпэу	naməsəpaw
нэмыӏэкӏэ	naməʔat͡ʃʼa
нэнау	nanaːw
нэнэжъ	nanaʐ
нэпашъо	napaːʃʷa
нэпкъы	napqə
нэплъэгъу	napɬaʁʷ
нэпс	naps
нэпх	napx
нэпцӏы	napt͡sʼə
нэпчыхьэ	napt͡ʃəħa
нэпчэдыжьы	napt͡ʃadəʑə
нэпэ	napa
нэпэон	napawan
нэпэталхьэ	napataːlħa
нэпэтелъхьэ	napatajɬħa
нэпэшъоон	napaʃʷawan
нэпэшъоутын	naɡʷəʃʷawtən
нэпэӏэплъэкӏ	napaʔapɬat͡ʃʼ
нэпӏэхъ	napʔaχ
нэриплъ	narəjpɬ
нэрыплъ	narəpɬ
нэсын	nasən
нэугъэупӏэпӏэгъу	nawʁawpʼapʼaʁʷ
нэутх	nawətx
нэущы	nawɕə
нэущымыщкӏь	nawɕəməɕkʲʼ
нэфнэ	nafna
нэфы	nafə
нэфын	nafən
нэхай	naxaːj
нэхаш	naxaːʃ
нэхъут	naχʷət
нэхь	naħ
нэхьышӏу	naħəʃʷʼə
нэцӏэкӏ	nat͡sʼat͡ʃʼ
нэчыхь	nat͡ʃəħ
нэчыхьытх	nat͡ʃəħətx
нэчэпэ	nat͡ʃapa
нэшакӏэ	naʃaːkʲʼa
нэшан	naʃaːn
нэшанэ	naʃaːn
нэшхъэигъу	naʃχajəʁʷ
нэшхъэин	naʃχajən
нэшхъэй	naʃχaj
нэшъу	naʂʷə
нэшэбэгу	naʃabaɡʷ
нэшэгъожь	naʃaʁʷaʑ
нэшӏошӏ	naʃʷʼaʃʼ
нэшӏошӏу	naʃʷʼaʃʷʼ
нэӏазэ	naʔaːza
нэӏаплъэкӏ	naʔaːpɬat͡ʃʼ
нэӏу	naʔʷ
нэӏуасэ	naʔʷaːsa
нэӏурыхъу	naʔʷərəχʷ
нэӏэбэсын	naʔabasən
о	wa
обзэгъу	wabzaʁʷ
оды	wadə
одыджын	wadəd͡ʒən
ожъубанэхьэмлыу	waʐʷbaːnaħamləw
ожьы	waʑə
олъэн	waɬan
он	wan
онджэкъ	wand͡ʒaq
онтэгъу	wantaʁʷ
онэгу	wanaɡʷ
опсэу	wapsaw
ор	war
оркъ	warq
оры	warə
орыжъ	warəʐ
орэд	warad
орэдаӏу	waradaːʔʷ
орэдус	wradwəs
орэдыӏон	waradəʔʷan
орэдыӏу	waradəʔʷ
ос	was
остыгъ	wastəʁ
осы	wasə
осылӏ	wasəɬʼ
осыпсы	wasəpsə
осӏэбыцу	wasʔabət͡sʷ
отыч	watət͡ʃ
отычыцэ	watət͡ʃət͡sa
отэгъу	wataʁʷ
отэр	watar
ошъогу	waʂʷaɡʷ
ошъоку	waʃʷakʷ
ошъолъапсэ	waʃʷaɬaːpsa
ошъочап	waʃʷat͡ʃaːp
ошъуапщэ	waʂʷaːpɕa
ошэкур	waʃakʷər
ошӏу	waʃʷʼə
ощхы	waɕxə
ощы	waɕə
ощыкӏ	waɕət͡ʃʼ
пагэ	paːɣa
пае	paːja
пакъ	paːq
пакӏо	paːkʷʼa
пакӏьэ	paːkʲʼa
пакӏэ	paːt͡ʃʼa
палътэу	paːɬtaw
панэ	paːna
папкӏэ	paːpt͡ʃʼa
папсӏэ	paːpsʼa
папцӏэ	paːpt͡sʼa
папыщ	paːpəɕ
парчъыхь	paːrtʂəħ
парчэ	paːrt͡ʃa
парэ	paːra
пахъэ	paːχ
пачъыхь	paːtʂəħ
пачъыхьагъо	paːt͡ʂəħaːʁʷa
пашъхьэ	paːʂħa
пащ	paːɕ
паӏо	paːʔʷa
пелыуан	pajɮəwaːn
пихын	pjəxən
пкъы	pqə
пкъыгъо	psəʃʷa
пкъыгъуацӏэ	pqəʁʷaːt͡sʼ
пкъышъолы	pqəʃʷalə
пкъэу	pqaw
пкьэн	pkʲan
пкӏантӏэ	pt͡ʃaːntʼa
пкӏатӏэ	pt͡ʃʼaːtʼa
пкӏау	pt͡ʃaːw
пкӏыкӏэ	pt͡ʃət͡ʃa
пкӏыхь	pt͡ʃəħ
пкӏыхьапӏ	pt͡ʃəħaːpʼ
пкӏышъхьэмышъхьэ	pt͡ʃəʂħaməʂħa
пкӏьэн	pkʲʼan
пкӏэ	pt͡ʃʼa
пкӏэн	pt͡ʃʼan
пкӏэнчъ	pt͡ʃʼant͡ʂ
пкӏэтэн	pt͡ʃʼatan
пкӏэшъэхъу	pt͡ʃaʂaχʷ
плъыжьгьэф	pɬəʑɡʲaf
плъыжьы	pɬəʑə
плъыжьыбз	pɬəʑəbz
плъышъо	pɬəʃʷa
плъэкӏун	pɬakʷʼən
плъэн	pɬan
плъэхъун	pɬaχʷən
плӏанэ	pɬʼaːna
плӏы	pɬʼə
плӏэмыепкъ	pɬʼaməjapq
плӏэмый	pɬʼaməj
плӏэнэбзы	pɬʼanabzə
прилъэшъон	prəjɬaʃʷan
прэзэн	prazan
псао	psaːwa
псапэ	psaːpa
псатхьэ	psaːtħa
псау	psaːwa
пскэн	pskan
псчэн	pst͡ʃan
псы	psə
псыбыб	psəbəb
псыгу	psəɡʷə
псыгъо	psəʁʷa
псыгъэхъун	psəʁaχʷən
псыжъ	psəʐ
псыжъо	psəʐʷa
псыжъы	psəʐə
псыкъефэх	psəqajfax
псыкъу	psəqʷ
псыкьэт	psəkʲat
псыкӏэ	psət͡ʃʼa
псыкӏэты	psəkʲʼatə
псыкӏэты	psət͡ʃʼatə
псыкӏэу	psət͡ʃʼaw
псылъэхъу	psəɬaχʷ
псын	psən
псынжъы	psənʐə
псынкӏагъэ	psət͡ʃʼaːʁa
псынкӏэ	psənt͡ʃʼa
псынкӏэн	psənt͡ʃʼan
псынкӏэу	psənt͡ʃʼaw
псынэ	psəna
псынэкъуау	psənaqʷaːw
псыор	psəwar
псысамыр	psəsaːmər
псытхьэ	psətħa
псытхьэгуащэ	psətħaɡʷaːɕa
псыуалъэ	psəəwaːɬa
псыунэ	psəwna
псыунэ	psəwəna
псыуцупӏэ	psəwət͡ʃʷəpʼa
псыхъо	psəχʷa
псыхъурай	psəχʷəraːj
псыхъуэгуащэ	psəχʷaɡʷaːɕa
псыхьэн	psəħan
псыцу	psət͡sʷa
псычэт	psət͡ʃat
псычэтыхъу	psət͡ʃatəχʷ
псычӏэгъы	psət͡ʂʼaʁə
псышъо	psəʃʷa
псышъонт	psəʂʷant
псышъуалъэ	psəʃʷaːɬa
псыӏушъо	psəʔʷəʃʷa
псыӏыгъыпӏэ	psəʔəʁəpʼa
псэ	psa
псэи	psajə
псэкӏод	psakʷʼad
псэлъыхъо	psaɬəχʷa
псэлъыхъон	psaɬəχʷən
псэлъыхъу	psaɬəχʷ
псэлъэн	psaɬan
псэн	psan
псэо	psawa
псэолъэшӏ	psawaɬaʃʼ
псэолъэшӏыпӏ	psawaɬaʃʼəpʼ
псэонгъэ	psawanʁa
псэу	psaw
псэуагъэ	psawaːʁa
псэуалъэ	psawaɬaʃʼəpʼ
псэун	psawən
псэушъхь	psawʂħ
псэхалӏэ	psaxaɬʼz
псӏанэ	psʼaːna
псӏын	psʼən
псӏырый	psʼərəj
пхъапэ	pχaːpa
пхъатэ	pχaːta
пхъацӏэ	pχaːt͡sa
пхъашэ	pχaːʃa
пхъон	pχʷan
пхъотэн	pχʷatan
пхъу	pχʷə
пхъуант	pχʷaːnt
пхъурылъф	pχərəɬf
пхъы	pχə
пхъэ	pχa
пхъэгулъ	bχaɡʷəɬ
пхъэжъые	pχaʐəj
пхъэкӏыпхъ	pχat͡ʃəpχ
пхъэкӏэн	pχat͡ʃan
пхъэмбай	pχambaːj
пхъэмбгъу	pχambʁʷ
пхъэн	pχan
пхъэнкӏын	pχant͡ʃʼən
пхъэнкӏыпхъ	pχant͡ʃʼəpχ
пхъэнтӏэкӏу	pχantʼakʷʼ
пхъэнтӏэкӏущыхьэ	pχantʼakʷʼɕəħa
пхъэныӏу	pχanəʔʷ
пхъэпхъэн	pχapχan
пхъэтакъэ	pχataːaqa
пхъэтэкъэжъ	pχataqaʐ
пхъэтӏэкӏу	pχatʼakʷʼ
пхъэуӏу	pχawʔʷə
пхъэх	pχax
пхъэхатӏэ	pχaxaːtʼa
пхъэцӏакӏэ	pχat͡sʼaːt͡ʃa
пхъэчай	pχat͡ʃaːj
пхъэчыпэ	pχat͡ʃəpa
пхъэшъхьэмышъхь	pχaːʂħaməʂħ
пхъэшъхьэмышъхьэхэр	pχaʂħaməʂħaxar
пхын	pxən
пхыр	pxər
пхэ	pxa
пхэдж	pxad͡ʒ
пхэкӏ	pxat͡ʃʼ
пхэндж	pxand͡ʒ
пцае	pt͡saːja
пцантхьэ	pt͡saːntħa
пцатхьэ	pt͡saːtħa
пцум	pt͡ʃʷəm
пцы	t͡səza
пцыкъо	pt͡səqʷa
пцыкъу	pt͡səqʷ
пцэ	pt͡sa
пцэжъые	pt͡saʐəja
пцэкъэнтф	pt͡saqantf
пцӏанэ	pt͡sʼaːna
пцӏы	pt͡sʼə
пцӏын	pt͡sʼən
пцӏырый	pt͡sʼərəj
пцӏыус	pt͡sʼəwəs
пцӏэун	pt͡sʼawəm
пчъаблэ	pt͡ʂaːbɮa
пчъагъэ	pt͡ʃaːʁa
пчъын	pt͡ʃən
пчъэ	pt͡ʃa
пчъэпсы	pt͡ʃapsə
пчъэӏу	pt͡ʃaʔʷə
пчъэӏупэ	pt͡ʃaʔʷəpa
пчы	pt͡ʃə
пчыкӏэ	pt͡ʃət͡ʃʼa
пчытӏаркъу	pt͡ʃətʼaːrqʷ
пчыхьапэ	pt͡ʃəħaːpa
пчыхьэ	pt͡ʃəħa
пчыхьэзэхахь	pt͡ʃəħazaxaːħ
пчыхьэшъхьашхэ	pt͡ʃəħaʂħaːʃxa
пчэ	pt͡ʃa
пчэгу	pt͡ʃaɡʷ
пчэдыгъо	pt͡ʃadəʁʷa
пчэдыжьы	pt͡ʃadəʑə
пчэдыжьышхэ	pt͡ʃadəʑəʃxa
пчэн	pt͡ʃan
пчэндэхъу	pt͡ʃandaχʷ
пчэны	pt͡ʃanə
пчэнышъо	pt͡ʃanəʃʷa
пшахъо	pʃaχʷa
пшъапӏэ	pʂaːpʼa
пшъашъэ	pʂaːʂa
пшъын	pʂən
пшъэ	pʂa
пшъэб	pʂab
пшъэбы	pʂabə
пшъэбыдэлъ	pʂabədaɬ
пшъэдадз	pʂadaːd͡z
пшъэдалхь	pʂadaːlħ
пшъэдалъхь	pʂadaːɬħ
пшъэдэкӏыжъ	pʂadat͡ʃəʐ
пшъэдэкӏыжь	pʂadat͡ʃəʑ
пшъэдэлъ	pʂadaɬ
пшъэрылъ	pʂarəɬ
пшъэтыкъ	pʂatəq
пшъэшъэгъу	pʂaʂaʁʷ
пшъэшъэжъые	pʂaʂaʐəja
пшъэшъэжъый	pʂaʂaʐəj
пшын	pʃən
пшысэ	pʃəsa
пшэсэн	pʃasan
пшэхъоф	pʃaχʷaf
пшӏанэ	pʃʼaːna
пшӏы	pʂə
пшӏы	pʃʼə
пщагъу	pɕaːʁʷ
пщтын	pɕtən
пщы	pɕə
пщыгъупшын	pɕəʁʷəpʃən
пщыкъу	pɕəqʷə
пщыкӏэ	pɕət͡ʃʼa
пщылӏы	pɕəɬʼ
пщылӏыгъо	pɕəɬʼəʁʷa
пщылӏын	pɕəɬʼən
пщын	pɕən
пщынао	pɕənaːwa
пщыныжьын	pɕənəʑən
пщынэ	pɕəna
пщынэжь	pɕənaʑ
пщынэн	pɕənan
пщынэныгъ	pɕənanəʁ
пщыпащ	pɕəpaːɕ
пщэ	pɕa
пщэры	pɕarə
пщэрыхь	pɕarəħ
пщэрыхьакӏо	pɕarəħaːkʷʼa
пщэрыхьан	pɕarəħaːn
пщэрыхьапӏэ	pɕarəħaːpʼa
пыгъэтэкъун	pəʁataqʷən
пыгъэун	pəʁawən
пыгъэхьан	pəʁaħaːn
пыдж	pəd͡ʒ
пыджэн	pəd͡ʒan
пыдзэгъ	pəd͡zʁ
пыдэн	pədan
пыжъ	pəʐ
пыжъы	pəʐə
пызы	pəzə
пызын	pəzən
пый	pəj
пыкьын	pəkʲən
пыкӏын	pəkʲʼən
пыкӏын	pət͡ʃʼən
пыкӏьын	pəkʲʼən
пыкӏэрэплъын	pət͡ʃʼarapɬən
пыл	pəl
пылъалъэ	pəɬaːɬa
пылъапӏ	pəɬaːpʼ
пылъапӏэ	pəɬaːpʼa
пылъын	pəɬən
пылъэн	pəɬan
пылэлын	pəɮaɮən
пылӏыкӏын	pəɬʼət͡ʃʼən
пындж	pənd͡ʒ
пынэн	pənan
пыпсыкӏын	pəpsət͡ʃʼən
пыскӏьэн	pəskʲan
пыскӏэн	pəst͡ʃan
пысын	pəsən
пысӏэн	pəsʼan
пытхъын	pətχən
пытын	pətən
пытэ	pəta
пытэкъун	pətaqʷən
пытӏэрын	pətʼarən
пыукӏын	pəwt͡ʃʼən
пыун	pəwən
пыупкӏын	pəwpt͡ʃʼən
пыут	pəwət
пыуты	pəwtə
пыхын	pəxən
пыхьан	pəħaːn
пыцӏэн	pətsʼan
пычын	pət͡ʃən
пышхэхьан	pəʃxaħaːn
пэ	pa
пэбжъакъо	pabʐaːqʷa
пэбзыджын	pabzəd͡ʒən
пэгъодз	paʁʷad͡z
пэгъокӏын	paʁʷat͡ʃən
пэгъокӏьын	paʁʷakʲən
пэгъон	paʁʷaːna
пэгъуанэ	paʁʷaːna
пэкъуэ	paqʷa
пэкӏо	pakʷʼa
пэкӏэракӏэу	pət͡ʃʼarapɬən
пэкӏэрэплъын	pət͡ʃʼarapɬən
пэлэлэжъ	palalaʐ
пэмкӏыр	pamt͡ʃər
пэмэн	paman
пэплъэн	papɬan
пэпсы	papsə
пэрыохъу	parəwaχʷ
пэсакӏо	pasaːkʷʼ
пэсын	pasən
пэтырэ	patəra
пэхьан	paħaːn
пэцуй	pat͡sʷəj
пэцуй	pat͡ʃʷəj
пэшын	paʃən
пэшӏыжьын	paʃʼəʑən
пэшӏэн	paʃʼan
пэщ	paɕ
пэщэн	paɕam
пэӏоталъхьэ	paʔʷataːlħa
пэӏоӏожьын	paʔʷaʔʷaʑən
пэӏухъо	paʔʷəχʷa
пэӏухъон	paʔʷəχʷan
пӏакӏэ	pʼaːt͡ʃa
пӏалъэ	pʼaːɬa
пӏастэ	pʼaːsta
пӏо	pʷʼa
пӏонкӏын	pʷʼant͡ʃʼəm
пӏоны	pʷʼanə
пӏуаблэ	pʷʼaːbɮa
пӏуакӏэ	pʷʼaːt͡ʃa
пӏуанкӏэ	pʷʼaːnt͡ʃa
пӏун	pʷʼən
пӏупкӏэ	pʷʼənt͡ʃʼa
пӏур	pʷʼər
пӏын	pʼən
пӏырагу	pʼəraːɡʷ
пӏысакӏо	pʼəsaːkʷʼa
пӏысыгъэжъ	pʼəsəʁaʐ
пӏысын	pʼəsən
пӏэ	pʼa
пӏэкӏор	pʼakʷʼar
пӏэркӏьын	pʼankʲʼəm
пӏэстхъэн	pʼastχan
пӏэстӏэкӏэшып	pastat͡ʃaʃəp
пӏэсхъэн	pʼasχan
пӏэтын	pʼatən
пӏэшъхьагъ	pʼaʂħaːʁ
ренэу	rajnaw
ригъэчъэхын	jaʁat͡ʂaxən
ридзын	rəjd͡ʒən
рилъэшъон	rəjɬaʃʷan
ришъун	rjəʃʷən
рсысын	səsən
рэзэгъэн	razaʁan
рэхьат	raħaːt
рэхьэнйэл	raħanjal
сабый	saːbəj
сагъындакъ	saːʁəndaːq
сае	saːja
сако	saːkʷa
сакӏо	saːkʷʼa
самбыр	saːmbər
самбырын	saːmbərən
сандыкъ	saːndəq
санэ	saːna
сапэ	saːpa
сахъэ	saːχa
стаф	staːf
стыгъэ	stəʁa
стылӏэн	stəɬʼan
стын	stən
стыр	stər
стырыпс	stərəps
сурэт	səwrat
суыз	fəz
суыз	ʃʷəz
суэу	faw
суэу	ʃʷaw
сшъхьэпкӏэтын	sʂħapkʲʼatən
сыд	səd
сыда	sədaː
сыдж	səd͡ʒ
сыдигъо	sədəjʁʷa
сыдэу	sədaw
сыдэущтэу	sədawɕtaw
сыдэущтэу	sədawɕtəw
сымагьэ	səmaːɡʲa
сымаджэ	səmaːd͡ʒa
сымэджаплъэ	səmad͡ʒaːpɬa
сымэджэдэй	səmad͡ʒadaj
сымэджэщ	səmad͡ʒaɕ
сын	sən
сырныч	sərnət͡ʃ
сырэ	səra
сысын	səsən
сыунэхъугъ	səwnaχʷəʁ
сыхьат	səħaːt
сэ	sa
сэку	sakʷ
сэкъат	saqaːt
сэмэгу	samaɡʷ
сэмэркъэу	samarqaw
сэмэркъэушӏыл	samarqawʃʼəɮ
сэнсэй	sansaj
сэнэтхьапэ	sanatħaːpa
сэнэхьат	sanaħaːt
сэпсэуэ	sapsawa
сэпэон	ɬapawan
сэраджэ	saraːd͡ʒa
сэрай	saraːj
сэхыжын	saxəʒən
сэхын	saxən
сӏакӏьэ	sʼaːkʲʼa
сӏын	sʼən
сӏынэ	sʼəna
сӏэ	sʼa
сӏэсӏэн	sʼasʼan
табэ	taːba
такъыр	taːqər
такъэ	taːqa
тамэ	taːma
таплъэ	taːpɬa
тары	taːrə
тауташ	taːwtaːɕ
тгъосэнэхьпэ	tʁʷasanaħpa
тгъуакӏо	tʁʷaːkʷʼa
тгъэнэгъургьэ	tʁanaʁʷərɡʲa
тгъэргъаз	tʁarʁaːz
тегощэн	ɡʷaɕən
тегубжыхьан	tajɡʷəbʒəħaːn
тегупшысыкӏын	tajɡʷəpʃəsət͡ʃʼən
тегущыӏэн	tajɡʷəɕəʔan
тегъогъон	tajʁʷaʁʷan
тегъэзын	tajʁazən
тегъэзэн	tajʁazən
тегъэкӏэн	tajʁat͡ʃʼan
тегъэнэн	tajʁanan
тегъэпкӏэн	tajəapt͡ʃʼan
тегъэпсыхьан	tajʁapsəħaːn
тегъэпытахьын	tajʁapətaːħaːn
тегъэстыкӏын	tajʁasət͡ʃʼən
тегъэстыхьан	tajʁasəħaːn
тегъэткӏон	tajʁatkʷʼan
тегъэтӏысхьан	tajʁatʼəsħaːn
тегъэтӏэтӏэн	ʁajtʼatʼan
тегъэун	tajʁawən
тегъэцӏырэн	tajʁat͡sʼəran
тедэжьын	tajdaʑən
тезын	tajzən
текьын	tajkʲən
текӏон	tajkʷʼan
текӏутэн	tajkʷʼətan
текӏьэн	takʲʼan
текӏэн	tajt͡ʃʼan
телъхьан	tajɬħaːn
телъэдэн	tajɬadan
телӏэхьын	tajɬʼaħən
темыр	tajmər
темэн	tajman
тенэн	tajnan
тенэцӏэхьын	tajnat͡sʼaħən
теон	tajwan
теплъэ	taːpɬa
теплъэшӏу	tajpɬaʃʷʼ
тепсэн	tajpsan
тепхэ	tajpxa
тепщэч	tajpɕat͡ʃ
тепӏо	tajpʷʼa
тетхыкӏын	tatxət͡ʃʼən
тетӏэтӏэн	tajtʼatʼan
теужъунтхэн	tajʒʷəntxan
теужъутхэн	tajʒʷəntxan
теунэхъухьан	tajnaχʷəħaːn
теупӏэпӏэн	tajwpʼapʼan
теутхын	tajawətxən
теутхэн	tjawətxən
теутын	tajwətən
теутэн	tajwətan
теуцон	tajdt͡ʃʷan
теуцӏэлэн	tawt͡sʼalan
тефэхьын	tajfaħən
техъон	tajχʷan
техьагъу	tajħaːʁʷ
техьан	tajħaːn
тецӏэлэн	tajt͡sʼaɮan
тецӏэцӏэн	tajt͡sʼat͡sʼan
течын	tajt͡ʃən
тещыныхьан	tajɕənəħaːn
теӏэбэхьын	tajʔabaħən
ткӏун	tkʷʼən
тутын	təwtən
тфанэ	tfaːna
тфы	tfə
тфый	tfəj
тфэи	tfajə
тхакӏо	txaːkʷʼa
тхъо	tχʷa
тхъу	tχʷə
тхъужъ	tχʷəʐ
тхъун	tχʷən
тхъурыжъ	tχʷərəʐ
тхъын	tχən
тхъытхъын	ɡʷəzaʒʷan
тхъэжьын	tχaʑən
тхъэн	ʁatχan
тхы	txə
тхыбзэ	txəbza
тхыгъэ	txəʁa
тхыдэ	txəda
тхыдэжъ	txədaʐ
тхыкъупшъхь	txəqʷəpʂħ
тхылъ	txəɬ
тхылъылъ	txəɬəɬ
тхылъыпӏэ	txəɬəpʼa
тхылъыщэ	txəɬəɕa
тхылъӏыгъыпӏэ	txəɬʔəʁəpʼa
тхын	txən
тхыон	txəwan
тхыпкъылъэ	txəpqəɬa
тхыпкъэ	txəpqa
тхытхын	txətxən
тхыцэ	txət͡ʃa
тхыцӏэ	txət͡sʼa
тхьабыл	tħaːbəl
тхьагъэпцӏ	tħaːʁapt͡sʼ
тхьакӏумкӏыхь	tħakʷʼmat͡ʃʼəħ
тхьакӏумэ	tħakʷʼma
тхьакӏын	tħat͡ʃən
тхьаматэ	tħaːmaːta
тхьамшӏыгъу	tħaːmʃʼəʁʷ
тхьамыкӏ	tħaːmət͡ʃ
тхьамыкӏагъу	tħaːmət͡ʃʼaːʁʷ
тхьамыкӏэгъо	tħaːmət͡ʃʼaːʁʷ
тхьанычъэ	tħaːnət͡ʂʼa
тхьапш	tħapʃ
тхьапэ	tħaːpa
тхьаркъо	tħaːrqʷa
тхьарыӏу	tħaːrəʔʷ
тхьауегъэпсэу	tħaːwajʁapsaw
тхьаумаф	tħawmaːf
тхьаусхэн	tħaːwəsxan
тхьауысхако	tħaːwəsxaːkʷa
тхьацэ	tħaːt͡sa
тхьачэт	tħaːt͡ʃat
тхьэ	tħa
тхьэгуащэ	tħaɡʷaːɕa
тхьэгъэлэдж	tħaʁalad͡ʒ
тхьэкӏумэ	tħakʷʼma
тхьэкӏумэкӏэхьы	tħakʷʼmakʲʼaħə
тхьэкӏумэкӏэхьы	tħakʷʼmat͡ʃʼaħə
тхьэкӏумэпылъ	tħakʷʼmapəɬ
тхьэкӏэт	tħakʲʼat
тхьэкӏэт	tħat͡ʃʼat
тхьэлъэӏупӏэ	tħaɬaʔʷəpʼa
тхьэматэ	tħamaːta
тхьэмафэ	tħamaːfa
тхьэмбылышъу	tħambələʂʷ
тхьэмыдэ	tħaməda
тхьэмышӏэ	tħaməʃʼa
тхьэмыщкӏь	tħaməɕkʲʼ
тхьэпкӏэ	tħapt͡ʃa
тхьэцу	tħat͡ʃʷ
тхьэчэт	tħat͡ʃat
тхэн	txan
тхэхьын	txaħən
ты	tə
тыгъон	təʁʷan
тыгъоснахьыпэ	təʁʷasnaːħəp
тыгъуакӏо	təʁʷaːkʷʼa
тыгъуасэ	təʁʷaːsa
тыгъуасэнахьыпэ	tʁʷasanaħpa
тыгъужъ	təʁʷəʐ
тыгъун	təʁʷən
тыгъурыгъу	təʁʷrəʁʷə
тыгъэ	təʁa
тыгъэгъазэ	təʁaʁaːz
тыгъэгъэзэмаз	təʁaʁazamaːz
тыгъэкъокӏыпӏ	təʁaqʷakʲəpʼ
тыгъэкъокӏыпӏ	təʁaqʷat͡ʃəpʼ
тыгъэкъохьапӏ	təʁaqʷaħaːpʼ
тыгъэнэгъунджэ	təʁanaʁʷənd͡ʒa
тыгъэнэстыр	təʁanastər
тыгъэпсы	təʁapsə
тыгъэстыр	təʁastər
тыдэ	təda
тыжьыны	təʑən
тыкъын	təqən
тын	tən
тыны	tənə
тыпсэ	təpsa
тыркъо	tərqʷa
тэ	ta
тэгъзакӏэ	taʁzaːkʲʼa
тэгъогъон	taʁʷaʁʷan
тэгъолъхьан	taʁʷaɬħaːn
тэгъэпсэхьэн	taʁapsaħaːn
тэгъэтӏысхьэн	taʁatʼəsħan
тэгъэтӏэтӏэн	ʁatʼatʼan
тэгъэфэн	taʁafan
тэгъэцӏэшъутыкӏын	taʁat͡sʼaʃʷtət͡ʃʼən
тэгьын	taɡʲən
тэджын	tad͡ʒən
тэдрэз	tadraz
тэжъутхэн	taʒʷətxan
тэкуон	takʷəwan
тэкӏу	takʷʼ
тэкӏурэ	takʷʼra
тэкӏутэн	takʷʼətan
тэмэжъый	bləpqəʐəj
тэнэн	tanan
тэпкӏэн	tapt͡ʃʼan
тэпсэ	tapsa
тэрэз	taraz
тэрэзыдж	tarazəd͡ʒ
тэсӏэсӏэн	tasʼasʼan
тэтхыкӏын	tatxət͡ʃʼən
тэтхыкӏьын	tatxəkʲʼən
тэтэжъ	tataʐ
тэтӏэтӏэн	tatʼatʼan
тэуцон	tawt͡sʷən
тэуцон	tawt͡ʃʷən
тэуцӏэлэн	tawt͡sʼalan
тэфэн	tafan
тэцӏэцӏэн	tat͡sʼat͡sʼan
тэцӏэшъутыкӏын	tat͡sʼaʃʷtət͡ʃʼən
тэцӏэшъутыкӏьын	tat͡sʼaʃʷtəkʲʼən
тэчъын	tat͡ʂən
тэшӏыкӏын	taʃʼət͡ʃʼən
тэшӏыкӏьын	taʃʼəkʲʼən
тэщгъум	taɕʁʷəm
тэщтэу	taɕtaw
тэщтэу	taɕtəw
тэӏэн	taʔan
тӏамы	taːmə
тӏаркъу	tʼaːrqʷ
тӏокӏы	tʷʼat͡ʃə
тӏокӏэжъ	tʷʼat͡ʃʼaʐ
тӏолъфэныкъо	tʷʼaɬfanəqʷa
тӏолъфэныкъох	tʷʼaːzax
тӏу	tʷʼə
тӏуазэ	tʷʼaːza
тӏуазэх	tʷʼaːzax
тӏуакӏэ	tʷʼaːt͡ʃʼa
тӏуанэ	tʷʼaːna
тӏупщын	tʷʼəpɕən
тӏурыс	tʷʼərəs
тӏурытӏу	tʷʼərətʷʼ
тӏуӏугъэ	tʷʼəʔʷəʁa
тӏы	tʼə
тӏыгъон	tʼəʁʷan
тӏын	tʼən
тӏыргун	tʼərɡʷən
тӏыргъон	tʼərʁʷan
тӏысын	tʼəsən
тӏысыпӏэ	tʼəsəpʼa
тӏэкӏу	tʼakʷʼ
тӏэкӏугъашӏэм	tʼakʷʼʁaːʃʼam
тӏэкӏунау	tʼakʷʼənaːw
тӏэкӏунитӏэ	tʼakʷʼəjntʼa
тӏэн	tʼan
тӏэпӏын	tʼsapʼən
тӏэрэхын	tʼaraxən
тӏэрэхьын	matʼaraħən
тӏэтэн	tʼatan
тӏэтӏэй	tʼatʼaj
тӏэтӏэн	tʼatʼan
уае	waːja
уалъэ	waːɬa
уанэ	waːna
уарзэ	waːrza
уасэ	waːsa
уатэ	waːta
уахътэ	waːχta
уашхъо	waːʃχʷa
уашъо	waːʃʷa
уащхъуэ	waːɕχʷa
убзэн	wəbzan
ублапӏэ	wəbɮaːpʼa
ублэгъу	wəbɮaʁʷ
убын	wəbə
убытын	wbətən
убэн	wəban
убэтэн	wəbatan
угощын	wəɡʷaɕən
угъоин	wəʁʷajən
угъонын	wəʁʷanən
угь	wəɡʲ
угьын	wəɡʲən
удж	wəd͡ʒ
уджын	wd͡ʒən
уджэгъун	wəd͡ʒaʁʷən
удзуцон	wd͡zʷət͡sʷan
уды	wədə
ужъунтхэн	wəʒʷəntxan
ужы	wʒə
уз	wəz
узы	wəzə
узын	wəzən
узыныгъэ	wəzənəʁa
укъэбзын	wqabzən
укӏакӏо	wt͡ʃʼaːkʷʼa
укӏорэин	wkʷʼarajən
укӏын	wət͡ʃʼən
укӏыт	wət͡ʃʼət
укӏытагъо	wət͡ʃʼətaːʁʷa
укӏытапх	wt͡ʃʼətaːpx
укӏытапхэ	wt͡ʃʼətaːpx
укӏытэн	wət͡ʃʼətan
укӏьын	wkʲʼən
укӏьытапх	wkʲʼətaːpx
укӏьытэн	wəkʲʼətan
укӏьэпхъэн	wkʲʼapχan
укӏэпхъэн	wt͡ʃʼapχan
укӏэсын	wət͡ʃʼasan
улъыин	wəɬəjən
улэлэн	wəlalan
улэун	wɮawən
умыармэ	wməaːrma
ун	jawən
унагъо	wnaːʁʷa
унагъобзэ	wənaːʁʷabza
унагъоцӏэ	wnaːʁʷat͡sʼa
унакӏэ	wənaːt͡ʃʼa
унапчъэ	wənaːpt͡ʂa
унашъо	wənaːʂʷa
унашъхьэ	wnaːʂħa
унэ	wəna
унэгъуацӏэ	wənaʁʷat͡sʼa
унэзэн	wnazan
унэкӏын	wənat͡ʃʼən
унэхъун	wənaχʷən
унэчӏэгъ	wənat͡ʃʼaʁ
унэшъошӏы	wnaʃʷaʃʼə
унэӏут	wənaʔʷət
упкӏэ	wəpt͡ʃʼa
упкӏэн	wəpt͡ʃʼan
упкӏэтэн	wəpt͡ʃʼatan
упсын	wəpsən
упхъон	wəpχʷan
упцӏын	wpt͡sʼən
упчӏэ	wəpt͡ʃʼa
упчӏэжьын	wpt͡ʂʼaʑən
упчӏэн	wəpt͡ʃʼan
упэпцӏын	wpapt͡sʼən
упэшӏын	wəpaʃʼən
упӏыцӏэн	wpʼəsʼan
упӏэпӏэн	wpʼapʼan
урам	wraːm
урыс	wərəs
усын	wsən
утхъоен	wətχʷajan
утхыпкӏын	wətxəpt͡ʃʼən
уты	wtə
утысэн	wətəsan
утэбжьэн	wətabʑan
утэцэн	wətat͡san
утэшъон	wtaʃʷan
утӏэтӏэн	wətʼatʼan
уфын	wəfən
уфэн	wfan
уфэупцӏэ	wəfawpt͡sʼa
ухъумэн	wχʷəman
ухын	wxən
уц	wət͡s
уцолъын	wət͡ʃʷaɬən
уцун	wt͡ʃʷən
уцупӏэ	wət͡sʷəpʼam
уцы	wət͡sə
уцышъо	wət͡səʂʷa
уцэкун	wət͡sakʷən
уцэӏун	wət͡saʔʷən
уцӏынын	wət͡sʼənən
уцӏэлэн	wət͡sʼalan
уцӏэрэпхъын	wət͡sʼarapχən
ушхъухьакӏо	wəʃχʷħaːkʷʼa
ушхъухьан	wəʃχʷħaːn
ушъорэкӏын	wəʃʷarat͡ʃʼən
ушъхьагъу	wəʂħaːʁʷ
ушъыбын	ʂəbən
ушъын	wəʂən
ушыгун	wəɕəɡʷən
ушыхьатын	wəʃəħaːtən
ушэтын	wəʃatən
ушӏоин	wəʃʷajən
уыбэтэн	wəbatan
уыд	wəd
уэнтэгъу	wantaʁʷ
уэр	war
уэрзэӏанэ	warzaʔaːna
уӏагъэ	wəʔaːʁa
уӏэн	wəʔan
фабэ	faːba
фае	faːja
фапшэ	faːpʃa
фапщэ	faːpʃa
фегъэпэн	fajʁapan
феуэн	fajwan
фигъэпэн	fəjʁapan
фикъун	fəjqʷən
фитын	fəjtən
фитыныгъ	fəjtənəʁ
фыгу	fəɡʷ
фыжьы	fəʑə
фыжьыбз	fəʑəbz
фызын	fəzən
фылым	fələm
фын	fən
фыцӏын	fət͡sʼən
фэ	fa
фэбае	fabaːja
фэбзэджэн	fabzad͡ʒan
фэгоӏэн	faɡʷaʔan
фэгубжын	faɡʷəbʒən
фэгуӏэн	faɡʷaʔan
фэгъэгъун	faʁaʁʷən
фэгъэзэн	faʁazan
фэгъэпсын	faʁapsən
фэгъэсэн	faʁasan
фэгъэшъошэн	faʁaʃʷaʃan
фэд	fad
фэдэгъэзын	fadaʁazən
фэдэкъабз	fadaqaːbz
фэдэн	fadan
фэен	fajan
фэкъолӏ	faqʷaɬʼ
фэкъулай	faqʷəɮaːj
фэлъэкӏын	ɬat͡ʃʼən
фэлъэкӏьын	ɬakʲʼən
фэлӏэн	faɬʼan
фэмылъэгъун	faməɬaʁʷən
фэмыф	faməf
фэмэн	faman
фэпсӏын	fapsʼən
фэпцӏын	fapt͡sʼən
фэпшэн	fapʃan
фэпщэн	fapʃan
фэпэн	fapan
фэрэзэн	farazan
фэрэхьатын	faraħaːtən
фэсакъын	fasaːqən
фэулэун	fawɮawən
фэусын	fawsən
фэшъуаш	faʃʷaːʃ
фэшъуашэу	faʃʷaːʃaw
фэшъхьаф	faʂħaːf
фэшӏ	faʃʼ
фэшӏкӏэ	faʃʼət͡ʃʼa
фэшӏу	faʃʷʼə
фэшӏун	faʃʷʼən
фэшӏыкӏэ	faʃʼət͡ʃʼa
фэшӏын	faʃʼən
фэшӏэн	faʃʷan
фэщэӏэн	faɕaʔan
фэӏаз	faʔaːz
фэӏофытэн	ʔʷafətan
фэӏэпыӏас	faʔapəʔaːs
хабзэ	xaːbza
хакӏо	xaːkʷʼa
хамэ	xaːma
ханэ	xaːna
хасэ	xaːsa
хатэ	xaːta
хафэ	xaːfa
хегъэхын	xaxən
хъагъэ	χaːʁa
хъан	χaːn
хъанзэгу	χaːnzaɡʷ
хъатэ	χaːta
хъашъо	χaːʃʷa
хъишъ	ħəjʂ
хъо	χʷa
хъожьын	χʷaʑən
хъои	χʷajə
хъокӏыгъ	χʷat͡ʃʼəʁ
хъонал	χʷanaːɮ
хъонэн	χʷanan
хъопсащэ	χʷapsaːɕa
хъопсэн	χʷapsan
хъоршэр	χʷarʃar
хъот	χʷat
хъоу	χʷaw
хъохъ	χʷaχʷ
хъохъу	ɡʷəʃʷʼaːʁʷa
хъу	χʷə
хъуае	χʷaːja
хъуакӏо	χʷaːkʷʼa
хъуанэ	χʷaːna
хъуат	χʷaːt
хъугъэ	χʷəʁa
хъужьын	χʷəʑən
хъулъфыгъэ	χʷəɬfəʁa
хъумэн	χʷəman
хъун	maχʷən
хъупхъэ	χʷəpχa
хъупцӏ	χʷəpt͡sʼ
хъупцӏын	χʷəpt͡sʼən
хъупӏэ	χʷəpʼa
хъурай	χʷəraːj
хъурмэ	χʷərma
хъусӏысый	χʷəsʼəsəj
хъучӏанэ	χʷət͡ʃaːna
хъушъу	χʷəʃʷ
хъы	χə
хъыбый	χəbəj
хъыен	χəjan
хъыжъэн	χəʐan
хъызмэт	χəzmat
хъыкӏы	χət͡ʃʼə
хъырбыдз	χərbəd͡ʒ
хъырцэ	χərt͡sa
хъытыу	χətəw
хъыу	χəw
хъэ	χa
хъэбар	χabaːr
хъэдз	χad͡z
хъэдэн	χadan
хъэн	χan
хъэпрашъо	χapraːʂʷa
хъэрен	χarajn
хъэхалъэ	χaxaːɬa
хъяр	χəjaːr
хъяркӏэ	χəjaːrt͡ʃʼa
хы	xə
хыбзу	xəbzəw
хыблыгу	xəbləɡʷə
хыгъунэ	xəʁʷəna
хыгъэхъун	xəʁaχʷən
хыгъэхъунэныкъу	xəʁaχʷənanəqʷə
хыкум	xəkʷəm
хыкъо	xəqʷa
хыкъохъу	xəqʷaχʷ
хыкъу	xəqʷə
хыкъумэ	xəqʷəma
хымацӏ	xəmaːt͡s
хымэ	xəma
хыор	xəwar
хырыкӏ	xərət͡ʃ
хысыдж	xəsəd͡ʒ
хытыгъужъ	xətəʁʷəʐ
хытӏуал	xətʷʼal
хыуай	xəwaj
хыуалъэ	xəwaːɬa
хыхьэ	xəħa
хыӏушъо	xəʔʷəʃʷa
хьа	ħaː
хьабзы	ħaːbzə
хьаблыу	ħaːbləw
хьадагъэ	ħaːdaːʁa
хьаджыгъэ	ħaːd͡ʒəʁa
хьаджыгъэпс	ħaːd͡ʒəʁaps
хьаджын	ħaːd͡ʒən
хьадэ	ħaːda
хьадэгъу	ħaːdaʁʷ
хьадэгъущ	ħaːdaʁʷəɕ
хьадэгъущэ	ħaːdaʁʷəɕa
хьадэпчэмыӏу	ħaːdapt͡ʃaməʔʷ
хьазыр	ħaːzər
хьазырын	ħaːzərən
хьайнап	ħajənaːp
хьайнапэ	ħajənaːp
хьаку	ħaːkʷ
хьакуако	ħakʷaːkʷa
хьакъун	ħaːqʷən
хьакӏэ	ħaːt͡ʃa
хьакӏэкъуакӏэ	ħaːt͡ʃʼaqʷaːt͡ʃʼa
хьакӏэщ	ħaːt͡ʃʼaɕ
хьалжъогъуан	ħaːlʐʷaʁʷaːn
хьалы	ħaːlə
хьалыгъу	ħaːləʁʷ
хьалыгъущапӏэ	ħaːləʁʷɕaːpʼa
хьалыжъощыхьагъэ	ħaːləʐʷaɕəħaːʁa
хьалэмэт	ħaːlamat
хьамлашкӏу	ħaːmɮaːʃkʷʼ
хьамлыу	ħamləw
хьамплъыжь	ħaːmpɬəʑ
хьан	ħaːn
хьандзу	ħaːnd͡zʷə
хьандзуачӏ	ħaːnd͡zʷaːt͡ʃ
хьантхъупсы	ħaːntχʷəpsə
хьантыкъуакъу	ħantəqʷaːqʷ
хьантӏаркъу	ħantaːrqʷ
хьанцэ	ħant͡sa
хьао	ħaːwa
хьапкӏ	ħaːpt͡ʃʼ
хьаплъы	ħaːpɬə
хьаплъэ	ħapɬa
хьапщ	ħapɕ
хьарз	ħarz
хьарзэ	ħaːpza
хьарун	ħaːrəwn
хьарыпӏ	ħaːrəpʼ
хьарыф	ħaːrəf
хьасэ	ħaːsa
хьасэтх	ħaːsatx
хьатыр	ħaːtər
хьатыякӏо	ħaːtəjaːkʷʼa
хьау	ħaw
хьаулый	ħaːwələj
хьаумэ	ħaːwma
хьацэ	ħaːt͡sa
хьацэгъуй	ħaːt͡saʁʷəj
хьацэпӏацэ	ħaːt͡sapʼaːt͡sa
хьашъо	ħaːʂʷa
хьаӏ	ħaːʔ
хьаӏьэ	ħaːʔʲa
хьилэ	ħəjla
хьылъэ	ħəɬa
хьын	ħən
хьэ	ħa
хьэб	ħab
хьэбадзэ	ħabaːd͡za
хьэбзу	ħabzəw
хьэблыу	ħabləw
хьэгъошӏыгъу	ħaʁʷaʃʼəʁʷ
хьэджашъу	ħad͡ʒaːʂʷ
хьэдрыхэ	ħadrəxa
хьэдрыхэтхьэ	ħadrəxatħa
хьэдэгъу	ħadaʁʷ
хьэдэджадэ	ħadad͡ʒaːda
хьэдэкъаз	ħadaqaːz
хьэдэпчэмыӏу	ħadapt͡ʃaməʔʷ
хьэжъ	ħaʐ
хьэжъу	ħaʐʷ
хьэинап	ħajənaːp
хьэкуаку	ħakʷaːkʷ
хьэкуку	ħakʷəkʷ
хьэкусташ	ħakʷəstaːʃ
хьэкъуашъо	ħaqʷaːʃʷa
хьэкъухъ	ħaqʷəʐ
хьэкӏапӏэ	ħat͡ʃʼaːpʼa
хьэкӏутӏэ	ħakʷʼətʼa
хьэкӏущтащхьэ	ħakʷʼɕtaːɕħa
хьэлжъо	ħalʐʷa
хьэлъэбакъо	ħaɬawbaːq
хьэлъэбакъу	ħaɬawbaːq
хьэлъэубакъу	ħaɬawbaːq
хьэлэбэлыкъ	ħaɮabaɮəq
хьэлэгъу	ħalaw
хьэлэгъу	ħaɮaw
хьэмашэ	ħamaːʃa
хьэнтӏэрэпӏый	ħantarapəj
хьэнцэ	ħant͡sa
хьэнчэмыӏу	ħant͡ʃaməʔʷ
хьэо	ħawa
хьэпс	ħaps
хьэпӏацӏэ	ħapʼaːt͡sʼa
хьэтӏрэпӏый	ħatrapəj
хьэуарзэ	ħawaːrza
хьэубыт	ħawbət
хьэуцхьэш	ħawt͡sħaʃ
хьэцэ	ħat͡sa
хьэцэӏукь	ħat͡saʔʷəkʲ
хьэцэӏукӏ	ħat͡saʔʷət͡ʃ
хьэшхъурэӏу	ħaʃχʷəraʔʷ
хьэшъобыдз	ħaʂʷabəd͡z
хьэшъутыубат	ħaʃʷətəwəbaːt
хьэят	ħajaːt
хьэӏу	ħaʔʷə
хьэӏуцӏ	ħaʔʷət͡sʼ
хэгущыӏэхьан	xaɡʷəɕəʔaħaːn
хэгъозэн	xaʁʷazan
хэгъолъхьан	xaʁʷaɬħaːn
хэгъошъхьаӏу	xaʁʷaʂħaʔʷ
хэгъощэн	xaʁʷaɕan
хэгъуашъхьэ	xaʁʷaːʂħa
хэгъэгу	xaʁaɡʷ
хэгъэгэжьын	xaʁanaʑən
хэгъэдэн	xaʁadan
хэгъэкӏын	xaʁat͡ʃən
хэгъэон	xaʁawan
хэгъэхъон	xaʁaχʷan
хэгъэщын	xaʁaɕən
хэдзын	xad͡zən
хэдэн	xadan
хэку	xakʷ
хэкъутыхьан	xaqʷətəħaːn
хэкъэхьын	xaqaħən
хэкӏ	xat͡ʃʼ
хэкӏодыкӏын	xakʷʼadət͡ʃʼəm
хэкӏодэн	xaʁʷaɕan
хэкӏодэхьын	xakʷʼadaħən
хэкӏон	xakʷʼan
хэкӏотагъ	xakʷʼataːʁ
хэкӏутэн	xakʷʼətan
хэкӏы	xat͡ʃʼə
хэкӏын	xakʲʼən
хэкӏын	xat͡ʃʼən
хэкӏьын	xakʲʼən
хэкӏьэн	xakʲʼan
хэкӏэн	xat͡ʃʼan
хэлъхьан	xaɬħaːn
хэлъын	xaɬən
хэлъэшъон	xaɬaʃʷan
хэнэжьын	xanaʑən
хэнэн	xanan
хэон	xawan
хэпкӏьэн	xapkʲan
хэпкӏэн	xapt͡ʃan
хэплъын	xapɬən
хэплъэн	xapɬan
хэпыгьэн	xapəɡʲan
хэпыджэн	xapəd͡ʒan
хэпэзэн	xapazan
хэстыхьан	xastəħan
хэсэн	xasan
хэт	xat
хэтэрыкӏ	xatarət͡ʃ
хэузыкӏын	xawzət͡ʃən
хэузыкӏьын	xawzəkʲən
хэукъон	xawqʷan
хэукӏэхьэн	xawkʲaħan
хэупсӏэн	xawpsʼan
хэупцӏэн	xawpt͡sʼan
хэутын	xawtən
хэуцон	xawt͡sʷən
хэуцон	xawt͡ʃʷən
хэуӏэн	xawʔan
хэхъон	xaχʷan
хэхын	xaxən
хэхьан	xaħaːn
хэшъон	xaʂʷan
хэшӏагъ	xaʃʼaːʁ
хэшӏыкӏын	xaʃʼət͡ʃʼən
хэшӏыкӏьын	xaʃʼəkʲən
хэшӏэн	xaʃʼan
хэщтыхьын	xaqaħən
хэщыжьын	xaɕəʑən
хэщын	xaɕən
хэщэн	xaɕan
хэӏалъ	xaʔaːɬ
хэӏон	xaʔʷan
хэӏуагъ	xaʔʷaʁ
хэӏун	xaʔʷən
хэӏэбэн	xaʔaban
хэӏэжьын	xaʔaʑən
цагэ	t͡saːɣa
цадльэ	d͡zaːʒa
цадльэ	t͡saːɣa
цако	t͡saːkʷa
цакӏьэ	t͡saːkʲʼa
цакӏэ	t͡saːt͡ʃʼa
цау	t͡saːw
цацэ	t͡saːt͡sa
цокъэкӏыхь	t͡ʃʷaqakʲʼəħ
цолъын	t͡ʃʷaɬən
цохъон	t͡sʷaχʷan
цу	t͡ʃʷə
цуабзэ	t͡sʷaːbza
цуакъо	t͡sʷaːqʷa
цуакъэ	t͡sʷaːqa
цугу	t͡sʷəɡʷ
цугу	t͡ʃʷəɡʷ
цужъ	t͡sʷəʐ
цуманэ	t͡sʷəmaːn
цумпэ	t͡sʷəmpa
цумпэ	t͡ʃʷəmpa
цумпэӏэрыс	t͡sʷəmpaʔarəs
цумпэӏэрыс	t͡ʃʷəmpaʔarəs
цунды	t͡sʷəndə
цунтхъэн	t͡ʃʷəntχan
цуэкъокӏэхь	t͡sʷaqʷakʲʼaħ
цуэкъокӏэхь	t͡sʷaqʷat͡ʃʼaħ
цуэкъокӏэхь	t͡ʃʷaqʷakʲʼaħ
цуэкъокӏэхь	t͡ʃʷaqʷat͡ʃʼaħ
цуӏ	t͡ʃʷəʔ
цы	t͡sə
цыгъо	t͡səʁʷa
цыгъон	t͡səʁʷan
цыгьан	t͡səɡʲaːn
цыджанэ	t͡səd͡ʒaːna
цые	t͡səja
цыз	t͡səz
цызэ	t͡səza
цыпэ	t͡səpa
цыулэ	t͡səwla
цыхьэ	t͡səħa
цыхьэмышӏ	t͡sʼəħaməʃʼ
цэ	t͡sa
цэкъэн	t͡saqan
цэлъэкӏ	t͡saɬat͡ʃ
цэлъэкӏалъэ	t͡saɬat͡ʃʼaːɬa
цэлы	t͡salə
цэф	t͡saf
цэхь	t͡saħ
цӏакӏэ	t͡sʼaːt͡ʃa
цӏапӏэ	t͡sʼaːpʼa
цӏашъутэ	t͡sʼaːʃʷta
цӏуцӏэ	ʃʷʼəsʼa
цӏуцӏэ	ʃʷʼət͡sʼa
цӏы	t͡sʼə
цӏыкӏу	t͡sʼəkʷʼ
цӏыкӏужъый	t͡sʼəkʷʼəʐəj
цӏыкӏуинтӏэ	t͡sʼəkʷʼəjntʼa
цӏыкӏунау	t͡sʼəkʷʼənaːw
цӏын	t͡sʼən
цӏынэ	tsʼəna
цӏыон	t͡sʼəwan
цӏыотэн	t͡sʼəwatan
цӏыун	t͡sʼəwən
цӏыфхэ	t͡sʼəfxa
цӏыфы	t͡sʼəfə
цӏыфыгъэ	t͡sʼəfəʁa
цӏыфышъхьэ	t͡sʼəfəʂħa
цӏыцӏын	t͡sʼət͡sʼən
цӏыӏргъ	tsəʔrʁ
цӏэ	t͡sʼa
цӏэжьын	t͡sʼaʑən
цӏэлъэн	t͡sʼaɬan
цӏэлэн	t͡sʼalan
цӏэнлъэн	t͡sʼaɬan
цӏэпапкӏ	t͡sʼapaːpt͡ʃʼ
цӏэпӏэжъ	t͡sʼapʼaʐ
цӏэрыӏу	t͡sʼarəʔʷ
цӏэтхъун	t͡sʼatχʷən
цӏэтхъын	t͡sʼatχən
цӏэтхын	t͡sʼatxən
цӏэцӏэн	t͡sʼat͡sʼan
цӏэшъутэн	t͡sʼaʃʷtan
чабэ	t͡ʃaːba
чан	t͡ʃaːn
чап	t͡ʃaːp
чатэ	t͡ʃaːta
чхыӏан	t͡ʃxəʔaːn
чъохъон	t͡ʃʷaχʷan
чъу	t͡ʃʷə
чъуакъо	t͡ʃʷaːqʷa
чъужъ	t͡ʃʷəʐ
чъуман	t͡ʃʷəmaːn
чъыг	tʂəɣ
чъыгай	tʂəɣaːj
чъыглэныстэ	tʂəɣlanəsta
чъыгу	t͡ʃʼəɡʷə
чъыгхатэ	t͡ʂəɣxaːta
чъыгшъхьацыз	t͡ʃəɣʂħaːt͡ʃəz
чъыгы	t͡ʂəɣə
чъыгыпкъы	t͡ʂəɣəpqə
чъыгышъхьэцыз	t͡ʂəɣəʂħat͡səz
чъые	t͡ʂəja
чъыен	t͡ʂəjan
чъын	t͡ʂən
чъыяпӏэ	t͡ʂəjaːpʼa
чъыӏалӏэ	t͡ʂəʔaːɬʼa
чъыӏаӏо	t͡ʂəʔaːʔʷa
чъыӏыхэн	t͡ʂəʔəxan
чъыӏэ	t͡ʂəʔa
чъэкӏыгъэ	t͡ʂat͡ʃʼəʁa
чъэн	tʂan
чъэныр	t͡ʃanər
чъэпыогъумаз	t͡ʂapəwaʁʷəmaːz
чъэхъун	t͡ʂaχʷən
чы	t͡ʃə
чыдан	t͡ʃədaːn
чыжьэ	t͡ʃəʑa
чыжьэу	t͡ʃəʑaw
чызмэ	t͡ʃəzma
чый	t͡ʃəj
чылапхъ	t͡ʃəlaːpχ
чылмэ	t͡ʃəlma
чылыс	t͡ʃəɮəs
чылысы	t͡ʃələsə
чылэ	t͡ʃəla
чылэ	t͡ʃəɮa
чылэгъу	t͡ʃəɮaʁʷ
чылэдэс	t͡ʃəɮadas
чынасыу	t͡ʃənaːsəw
чырбыч	t͡ʃərbət͡ʃ
чырбыщ	t͡ʃərbəɕ
чыфыт	t͡ʃəfət
чыян	t͡ʃəjaːan
чыӏу	t͡ʃʼəʔʷ
чыӏун	t͡ʃəʔʷən
чыӏхэн	t͡ʃəʔxan
чэ	t͡ʃa
чэгый	t͡ʃaɣəj
чэзыу	t͡ʃazəw
чэкӏошъыкӏын	t͡ʃakʷʼaʂəkʲən
чэл	t͡ʃal
чэм	t͡ʃam
чэмахъо	t͡ʃamaːχʷa
чэмы	t͡ʃamə
чэмыбгъэ	t͡ʃaməbʁa
чэмыл	t͡ʃaməl
чэмышъо	t͡ʃaməʃʷa
чэмыӏо	t͡ʃaməʔʷa
чэмэдан	t͡ʃamadaːn
чэн	t͡ʃan
чэндж	t͡ʃand͡ʒ
чэпзэхэогъу	t͡ʃapzaxawaʁʷ
чэркэс	t͡ʃarkas
чэрэгъун	t͡ʃaraʁʷən
чэрэз	t͡ʃaraz
чэрэзын	t͡ʃarazən
чэрэуан	karawaːn
чэсэй	t͡ʃasaj
чэтапэ	t͡ʃataːpa
чэтжъые	t͡ʃʼatʐəj
чэтхъэн	t͡ʃʼatχan
чэты	t͡ʃatə
чэтыл	t͡ʃatəl
чэтыу	t͡ʃatəw
чэтышх	t͡ʃatəʃx
чэу	t͡ʃʼaw
чэупчъэ	t͡ʃawəpt͡ʂa
чэфы	t͡ʃafə
чэфын	t͡ʃafən
чэфынчъэ	t͡ʃafənt͡ʂa
чэфынчъэн	t͡ʃafənt͡ʂan
чэфыныпхъ	t͡ʃafənəpχ
чэщ	t͡ʃaɕ
чэщдэс	t͡ʃaɕdas
чэщныкъо	t͡ʃaɕənəqʷa
чэщтао	t͡ʃaɕtaːwa
чэщтеу	t͡ʃaɕtajw
чэщы	t͡ʃaɕə
чэщыбзыу	t͡ʃaʃəbsəw
чӏитхъун	t͡ʃʼəjtχʷən
чӏы	t͡ʂʼə
чӏыбгъэ	ħaːsatx
чӏыбжь	t͡ʃəbʑ
чӏыбзу	t͡ʃəbzəw
чӏыгу	t͡ʃʼəɡʷə
чӏыгъыкӏэлъыбз	t͡ʃəʁət͡ʃaɬəbz
чӏыдагъ	t͡ʃədaːʁ
чӏыкъу	t͡ʃəqʷ
чӏыкӏухьныкъу	t͡ʃəkʷəħnəqʷ
чӏылъ	t͡ʃʼəɬ
чӏылъэ	t͡ʃʼəɬa
чӏылъэныкъу	t͡ʃəɬanəqʷ
чӏылъэтеплъ	t͡ʃəɬatajpɬ
чӏымэтх	t͡ʃəmatx
чӏыопс	t͡ʃəwaps
чӏыплъ	t͡ʃəpɬ
чӏыпӏалъэ	t͡ʂʼəpʼaːɬa
чӏыпӏэ	t͡ʂʼəpʼa
чӏыпӏэрыс	t͡ʂʼəpʼarəs
чӏыр	t͡ʃʼər
чӏырыгъыс	t͡ʃʼərəʁəs
чӏырыкӏу	t͡ʃərəkʷ
чӏытхъыцэхэр	t͡ʃətχət͡saxar
чӏыунэ	wnaːʂħa
чӏыфэ	t͡ʂʼəfa
чӏышъутын	t͡ʂʼəʃʷtən
чӏэ	t͡ʃʼa
чӏэбын	t͡ʂʼabən
чӏэгъолъхьан	t͡ʃʼaʁʷaɬħaːn
чӏэгъэкӏын	t͡ʂʼaʁat͡ʃʼən
чӏэгъэсӏэн	t͡ʃʼaʁasʼan
чӏэгъэцӏэн	t͡ʂʼat͡sʼan
чӏэкӏын	t͡ʂʼat͡ʃʼən
чӏэкӏьын	t͡ʂʼakʼən
чӏэлъхьан	t͡ʂʼaɬħan
чӏэлъэтыкӏьын	t͡ʃʼaɬatəkʲən
чӏэн	t͡ʃʼan
чӏэнэн	t͡ʃanan
чӏэрэп	t͡ʂʼarap
чӏэсэн	t͡ʂʼasan
чӏэсӏэн	t͡ʃʼasʼan
чӏэтэкъун	t͡ʂʼataqʷən
чӏэухъубэн	t͡ʂʼawχʷəban
чӏэухъумэ	t͡ʂʼawχʷəma
чӏэухъумэн	t͡ʂʼawχʷəman
чӏэхьан	t͡ʂʼəħan
чӏэхьапкӏэ	t͡ʃʼaħaːpt͡ʃa
чӏэцӏэн	t͡ʂʼat͡sʼan
чӏэшъутын	t͡ʂʼaʃʷtən
чӏэщыкӏьын	tʂaɕəkʼən
чӏэӏотыкӏын	t͡ʂʼaʔʷatət͡ʃʼən
чӏэӏотыкӏьын	t͡ʂʼaʔʷatəkʲʼən
шакӏо	ʃaːkʷʼa
шамгьэн	ʃamɡʲan
шамйэ	ʃaːmja
шапсыгъэбзэ	ʃapsəʁabza
шапхъэ	ʃaːpχa
шашыф	ʃaːʃəf
шкӏэ	ʃkʼa
штэ	ɕta
штэн	ʃtan
шу	ʃəw
шхапӏэ	ʃxaːpʼa
шхъогъон	ʃχʷaʁʷan
шхъомч	ʃχʷamt͡ʃ
шхъуантӏэ	ʃχʷaːntʼa
шхъуатӏэ	ʃχʷaːtʼa
шхэкӏын	ʃxat͡ʃʼən
шхэн	ʃxan
шъабэ	ʂaːba
шъагъэ	ʂaːʁa
шъао	ʂaːwa
шъо	ʃʷa
шъоблыр	ʃʷabɮər
шъоджан	ʃʷad͡ʒaːn
шъодэны	ʃʷadənə
шъойцый	ʃʷajt͡səj
шъомпӏэжъ	ʃʷampʼaʐ
шъоны	ʃʷanə
шъорышӏ	ʃʷarəʃʼ
шъорышӏын	ʃʷarəʃʼən
шъотехьэтекӏ	ʂʷatajħatajt͡ʃ
шъотэгын	ʂʷataɣən
шъоу	ʂʷaw
шъоуалъэ	ʃʷawaːɬa
шъоущыгъу	ʃʷawɕəʁʷ
шъофбзыу	ʂʷafbzəw
шъофы	ʂʷafə
шъохътан	ʃʷaχtaːn
шъуабгъо	ʃʷaːbʁʷaː
шъуаджэ	ʃʷaːd͡ʒa
шъуае	ʂʷaːja
шъуакӏо	ʂʷaːkʷʼa
шъуалъэ	ʂʷaːɬa
шъуамбгъо	ʂʷaːmbʁʷaː
шъуампӏэ	ʃʷʼaːmpʼa
шъуапэ	ʂʷaːpa
шъуапӏэ	ʃʷʼaːpʼa
шъуатэ	ʃʷaːta
шъуашэ	ʃʷaːʃa
шъугъон	ʃʷʁʷan
шъугъун	ʃʷəʁʷən
шъуен	ʃʷəjan
шъуз	ʂʷəzə
шъузабэ	ʃʷəzaːba
шъуил	ʃʷəjaːɮ
шъуин	ʃʷəjan
шъун	ʃʷən
шъуты	ʃʷətə
шъутыгъуанэ	ʃʷətəʁʷaːna
шъутыжъ	ʃʷətəʐ
шъутыпашъо	ʃʷətəpaːʃʷa
шъутыпсӏэ	ʃʷətəpsʼa
шъутыпцӏэ	ʃʷətəpsʼa
шъутырын	ʃʷətəran
шъутырэхьын	ʃʷətəraħən
шъухъогъон	ʃʷəχʷaʁʷan
шъуял	ʃʷəjaːɮ
шъуялъэ	ʃʷəjaːɬa
шъхъэи	ʂħajə
шъхьадж	ʂħaːd͡ʒ
шъхьадэхьан	ʂħaːdaħaːnn
шъхьае	ʂħaːja
шъхьакӏо	ʂħaːkʷʼa
шъхьакӏун	ʂħaːkʷʼən
шъхьакӏэ	ʂħaːt͡ʃʼa
шъхьалы	ʂħaːlə
шъхьангъупчъэ	ʂħaːnʁʷəptʂa
шъхьанд	ʂħaːnd
шъхьантэ	ʂħaːnta
шъхьапсӏэ	ʂħaːpt͡sʼa
шъхьапцӏэ	ʂħaːpt͡sʼa
шъхьарыгущыӏ	ʂħaːrəɡʷəɕəʔ
шъхьарыхъон	ʂəħaːrəχʷan
шъхьас	ʂħaːs
шъхьасын	ʂħaːsən
шъхьатэ	ʂħaːta
шъхьафы	ʂħaːfə
шъхьахын	ʂħaːxən
шъхьацы	ʂħaːt͡sə
шъхьацышъо	ʂħaːt͡səʃʷa
шъхьач	ʂħaːt͡ʃ
шъхьашыгу	ʂħaːʃəɡʷ
шъхьэ	ʂħa
шъхьэатынгъэ	ʂħaʔaːtənʁa
шъхьэгъусэ	ʂħaʁʷəsa
шъхьэгьашъу	ʂħaɡʲaːʃʷ
шъхьэджашъу	ʂħad͡ʒaːʃʷ
шъхьэкъуй	ʂħaqʷəj
шъхьэкӏафэ	ʂħat͡ʃʼaːfa
шъхьэкӏьэ	ʂħakʲʼa
шъхьэкӏэфэныгъ	ʂħat͡ʃʼafanəʁ
шъхьэмажьэ	ʂħamaːʑa
шъхьэнгъупчъэ	ʂħanʁʷəptʂa
шъхьэныкъо	ʂħanəqʷa
шъхьэпай	ʂħapaːj
шъхьэпразэ	ʂħapraːza
шъхьэпылъапӏэ	ʂħapəɬaːpʼa
шъхьэпэкӏын	ʂħapat͡ʃʼən
шъхьэпэкӏьын	ʂħapakʲʼən
шъхьэталъхьэ	ʂħataːɬħa
шъхьэтелъхьэ	ʂħatajɬħa
шъхьэтепхъу	ʂħatajpχʷ
шъхьэтехъу	ʂħatajχʷ
шъхьэубат	ʂħawbaːt
шъхьэубэтагъ	ʂħawbaːt
шъхьэузы	ʂħawəzə
шъхьэукъэн	ʂħawqan
шъхьэфэшӏужь	ʂħafaʃʷʼəʑ
шъхьэхъу	ʂħaχʷ
шъхьэц	ʂħat͡s
шъхьэщытхъужь	ʂħaɕətəχəʑ
шъхьэӏатынгъэ	ʂħaʔaːtənʁa
шъхьэӏужъу	ʂħaʔʷəʐʷ
шъхьэӏух	ʂħaʔʷəx
шъыбын	ʂəbən
шъыгъо	ʂəʁʷa
шъыд	ʂəd
шъыда	ʂədaː
шъыдгъо	ʂədʁʷa
шъыдигъо	ʂədʁʷa
шъыдэу	ʂədaw
шъыкӏэ	ʂəkʲa
шъынэ	ʂəna
шъыпкъэ	ʂəpqa
шъыпкъэмкӏэ	ʂəpqamt͡ʃʼa
шъыпкъэу	ʂəpqaw
шъырыт	ʂərət
шъыхь	ʂəħ
шъыхьэ	ʂəħa
шъэ	ʂa
шъэгьашъ	ʂaɡʲaːʂ
шъэджашъ	ʂad͡ʒaːʂ
шъэджэшъэжъ	ʂad͡ʒaːʂəʐ
шъэжъые	ʂaʐəja
шъэжъыяц	ʂaʐəjaːt͡s
шъэн	ʂan
шъэнэкъо	ʂanaqʷa
шъэо	ʂawa
шъэогъу	ʂawaʁʷ
шъэожъые	ʂawaʐəja
шъэфы	ʂafə
шы	ʃə
шыбгъэ	ʃəbʁa
шыбзы	ʃəbzə
шыблэ	ʃəbla
шыгу	ʃəɡʷ
шыгугъон	ʃəɡʷʁʷan
шыгъо	ʃəʁʷa
шыдгъо	ʃədʁʷa
шыдзыен	ʃəd͡ʒəjan
шыдкъолэн	ʃədqʷalan
шыкъолэн	ʃəqʷalan
шыкъу	ʃəqʷ
шыкӏадзэ	ʃət͡ʃʼaːd͡za
шыкӏэ	ʃət͡ʃa
шыкӏэпшынэ	ʃəkʲapʃəna
шын	ʃən
шынахьыжъ	ʃənaːħəʐ
шынахьыкӏ	ʃənaːħət͡ʃʼ
шыпхъу	ʃəpχʷ
шыпын	ʃəpən
шыр	ʃər
шытепхъо	ʃətajpχʷa
шыу	ʃəw
шыукӏытэн	ʃəwt͡ʃʼətan
шыукӏьытэн	ʃəwkʲʼətan
шыфэн	ʃəfan
шыхъон	ʃəχʷan
шыхьат	ʃəħaːt
шышъхьэӏумаз	ʃəʂħaʔʷəmaːz
шэдыгъо	ʃadəʁʷa
шэзгъэ	ʃazʁa
шэкэр	ʃakʲar
шэкэрхафэ	ʃakʲarxaːfa
шэкэрыпс	ʃakʲarəps
шэкӏ	ʃat͡ʃʼ
шэкӏогъумаз	ʃakʷʼaʁʷəmaːz
шэкӏуахь	ʃakʷʼaːħ
шэмбэт	ʃambat
шэн	ʃan
шэнджэ	ʃand͡ʒa
шэнтэ	ʃanta
шэнчъэ	ʃant͡ʂa
шэны	ʃan
шэнынчъ	ʃant͡ʂa
шэнынчъэ	ʃant͡ʂa
шэнычъэ	ʃant͡ʂa
шэплъы	ʃapɬə
шэпсэун	ʃapsawən
шэрсэн	ʃarsan
шэфы	ʃafə
шэчалъ	ʃat͡ʃaːɬ
шэшэн	ʃaʃan
шӏагъо	ʃʼaːʁʷa
шӏобзы	ʃʷʼabzə
шӏобзын	ʃʷʼabzən
шӏогъэшӏэгъонын	ʃʷʼaʁaʃʼaʁʷan
шӏои	ʃʷʼajə
шӏоигъоджэн	ʃʷajəʁʷad͡ʒan
шӏоигъон	ʃʷajəʁʷan
шӏоигъуадж	ʃʷajəʁʷaːd͡ʒ
шӏоилъ	ʃʷʼajəɬ
шӏойбэхь	ʃʷʼajbaħ
шӏокӏон	ʃʷʼakʷʼan
шӏокӏын	ʃʷʼat͡ʃʼən
шӏокӏьын	ʃʷʼakʲʼən
шӏомыкӏы	ʃʷʼamət͡ʃʼ
шӏошъхъуныгъэ	ʃʷʼaʃʷʼχʷənʁa
шӏошъын	ʃʷaʂən
шӏошӏ	ʃʷʼaʃʷ
шӏошӏун	ʃʷaʃʷən
шӏошӏухъунгъэ	ʃʷʼaʃʷʼχʷənʁa
шӏошӏухъуныгъэ	ʃʷʼaʃʷʼχʷənʁa
шӏошӏын	ʃʷaʃʼən
шӏоӏун	ʃʷʼaʔʷən
шӏу	ʃʷʼə
шӏуабэ	ʃʷʔaːba
шӏуалъэ	ʃʷʼaːɬa
шӏуанэ	ʃʷʼaːna
шӏугуащэ	ʂʷəɡʷaːɕa
шӏугъэ	ʃʷʼəʁa
шӏуежьэжьын	ʃʷʼajʑaʑən
шӏулъэгъун	ʃʷʼəɬaʁʷən
шӏункӏы	ʃʷʼənt͡ʃə
шӏупщы	ʂʷəpɕə
шӏусӏэ	ʃʷʼəsʼa
шӏуфэс	ʃʷʼəfas
шӏухъогъон	ʃʷʼəχʷəʁʷan
шӏухьафтын	ʃʷʼəħaːftən
шӏуцӏагъэ	ʃʷʼt͡sʼaːʁa
шӏуцӏэ	ʃʷʼət͡sʼa
шӏушӏэ	ʃʷʼəʃʼa
шӏыбзыу	ʃʼəbzəw
шӏыжьын	ʃəʑən
шӏыкӏай	ʃʼət͡ʃʼaːj
шӏыкӏашӏу	ʃʼət͡ʃʼaːʃʷʼ
шӏыкӏьэ	ʃʼəkʲʼa
шӏыкӏэ	ʃʼət͡ʃʼa
шӏыкӏэен	ʃʼət͡ʃʼajan
шӏын	ʃən
шӏыхьагъэ	ʃʼəħaːʁa
шӏыхьан	ʃʼəħaːn
шӏэн	ʃan
шӏэнгъэ	ʃʼanʁa
шӏэныгъэ	ʃʼanəʁa
шӏэпэн	ʃʼapan
шӏэхын	ʃʼaxən
шӏэхэу	ʃʼaxaw
щабзэ	ɕaːbza
щагу	ɕaɡʷ
щае	ɕaːja
щазымэ	ɕaːzəma
щаибжъэ	ɕaːjəbʐa
щайныч	ɕaːjnət͡ʃ
щайуц	ɕaːjwət͡s
щалъ	ɕaːɬ
щамсый	ɕaːmsəj
щанэ	ɕaːna
щао	ʃaːwa
щапӏэ	ɕaːpʼa
щкъэн	ɕqan
щтапхэ	ɕtaːpxa
щтын	ɕtən
щтыргъукӏы	ɕtərʁʷət͡ʃ
щтэ	ɕta
щтэн	ɕtan
щтэпхэрый	ɕtapxarəj
щхъырыб	ɕχərəb
щхын	ɕxən
щхыпцӏы	ɕxəpt͡sʼ
щхыпцӏын	ɕxəpt͡sʼən
щхэны	ɕxanə
щы	ɕə
щыбжьый	ɕəbʑəj
щыблэ	ɕəbla
щыбырысыр	ɕəbərəsər
щыгугъын	ɕəɡʷəʁən
щыгушӏукӏын	ʃəɡʷəʃʷʼt͡ʃʼən
щыгушӏукӏьын	ʃəɡʷəʃʷʼkʲʼən
щыгъозэн	ɕəʁʷazan
щыгъу	ɕəʁʷ
щыгъупшын	ɕəʁʷəpʃən
щыгъущ	ɕəʁʷəɕ
щыгъын	ɕəʁən
щыгъэгуфэн	ɕəʁaɡʷəfan
щыгъэгъупщын	ɕəʁaʁʷəpʃən
щыгъэзыен	ʃəʁazəjan
щыгъэзын	zəɕəʁaʁʷəpʃən
щыгъэн	ɕəʁan
щыгъэтын	ɕəʁatən
щыгъэӏэн	ɕəʔan
щыды	ɕədə
щыдыхьэщхын	ɕədəħaɕxən
щыдэхьащхын	ɕədəħaɕxən
щызымэ	ɕəzəma
щызэу	ɕəzaw
щыкӏагъэ	ɕət͡ʃʼaːʁa
щыкӏэгъэн	ɕət͡ʃʼaʁan
щыкӏэн	ɕət͡ʃʼan
щыкӏэпс	ɕəkʲʼaps
щылъэн	ɕəɬan
щылыч	ɕələt͡ʃ
щылэмаз	ɕəlamaːz
щымыгъуаз	ɕəməʁʷaːz
щымын	zawəʂafən
щымэхъэшэн	ɕəmaχaʃan
щынагъо	ɕənaʁʷa
щынагъу	ɕənaːʁʷ
щынапхэ	ɕənaːpxa
щыны	ɕənə
щынэжьын	ɕənaʑən
щынэн	ɕənan
щыпын	ɕəpən
щыпэлъф	ɕəpaɬf
щыр	ɕər
щырыкъу	ɕərəqʷ
щысыпӏэ	ɕəsəpʼa
щысэ	ɕəsa
щысэхъукӏын	ɕəsaχʷət͡ʃʼən
щытапхэ	ɕtaːpxa
щытхъу	ɕətχʷ
щытхъун	ɕətχʷən
щытын	ɕətən
щыуан	ɕəwaːn
щыуанкъопс	ɕəwaːnqʷaps
щыуаныжъ	ɕəwaːnəʐ
щыугъэ	ɕəwəʁa
щыун	ɕəwən
щыфэн	ɕəfan
щыхын	ɕəxən
щыхьан	ɕəħaːn
щыхьэн	ɕəħan
щышӏын	ɕəʃən
щыщынэн	ɕəɕənan
щыщэн	ɕəɕan
щыӏ	ɕəʔ
щыӏэн	ɕəʔan
щыӏэцӏэ	ɕəʔat͡sʼa
щэ	ɕa
щэбзащ	ɕabzaːɕ
щэгъэпцӏагъэ	ɕaʁapt͡sʼaːʁa
щэгьагъо	ɕad͡ʒaːʁʷa
щэгьагъо	ɕaɡʲaːʁʷa
щэгьэгъож	ɕaɡʲaʁʷaʒ
щэгьэгъожь	ɕaɡʲaʁʷaʒ
щэгьэгъоуж	ɕaɡʲaʁʷaʒ
щэдж	ɕad͡ʒ
щэджагъо	ɕad͡ʒaːʁʷa
щэджэгъоуж	ɕad͡ʒaʁʷawʒ
щэджэгъуашхэ	ɕad͡ʒaʁʷaːʃxa
щэкьын	ɕakʲən
щэкӏы	ɕat͡ʃə
щэн	ɕan
щэный	ɕanəj
щэрыу	ɕarəw
щэрыхъ	ɕarəχ
щэрэб	ɕarab
щэрэхъ	ɕaraχ
щэуалэ	ɕawaːɮa
щэфын	ɕafən
щэхъу	ɕaχʷ
щэхьын	ɕaħən
щэчанэ	ɕat͡ʃaːna
щэчын	ɕat͡ʃən
щэӏун	ɕaʔʷən
ыгузэгу	əɡʷəzaɡʷ
ыгупэн	əɡʷəpan
ыгъэпэн	əʁapan
ыкъудыин	əqʷədəjən
ыкӏи	ət͡ʃʼəj
ымышӏахэу	əməʃʼaːxaw
ыунэхъун	ʁawnaχʷʁn
ыцӏэжьын	ət͡sʼaʑən
ычӏэгъ	ət͡ʃʼaʁ
ышъхьагъ	əʂħaːʁ
ышӏэпэн	əʃʼapan
ягъэ	jaːʁa
яжьашъу	jaːʑaːʂʷ
яжьэ	jaːʑa
язырэ	jaːzəra
якъуб	jaːqʷəb
ялыегъэ	jaːɮəjaʁa
янэ	jaːna
янэхь	jaːnaħ
янэш	jaːnaʃ
япхъурэлъф	aːpχʷəraɬf
япэ	jaːpa
япэрэ	jaːpara
япэрэу	jaːparaw
ятэ	jaːta
ятэш	jaːtaʃ
ятӏэ	jaːtʼa
яужым	jaːwʒəm
ӏа	ʔaː
ӏаджэ	ʔaːd͡ʒa
ӏадэ	ʔaːda
ӏае	ʔaːja
ӏазэ	ʔaːza
ӏалъмэкъ	ʔaːɬmaq
ӏалы	ʔaːɮə
ӏанлъэ	ʔaːnɬa
ӏанэ	ʔaːna
ӏаплӏэ	ʔaːpɬʼa
ӏапшъ	ʔaːpʂ
ӏапэ	ʔaːpa
ӏапӏэ	ʔaːpʼa
ӏасэ	ʔaːsa
ӏасэу	ʔaːsaw
ӏахъо	ʔaχʷa
ӏахь	ʔaːħ
ӏахьыл	ʔaːħəɮ
ӏашкӏ	ʔaːʃt͡ʃʼ
ӏашэ	ʔaːʃa
ӏашэнчъ	ʔaːʃatnt͡ʂ
ӏашэнчъэ	ʔaːʃatnt͡ʂa
ӏашӏу	ʔaʃʷʼə
ӏекӏын	ʔʲat͡ʃʼən
ӏелъын	ʔajɬən
ӏо	ʔʷa
ӏогъолъхьан	taʁʷaɬħaːn
ӏоен	ʔʷajan
ӏолӏэн	ʔʷaɬʼan
ӏон	ʔʷan
ӏонтагъ	ʔʷantaːʁ
ӏоныгъомаз	ʔʷanəʁʷamaːz
ӏоржъор	ʔʷarʒʷar
ӏорытх	ʔʷarətx
ӏорышӏадж	ʔʷarəʃʼaːd͡ʒ
ӏорышӏэ	ʔʷarəʃʼa
ӏорышӏэджэн	ʔʷarʃʼad͡ʒan
ӏорышӏэн	ʔʷarʃʼan
ӏорӏотэжь	ʔʷarʔʷataʑ
ӏоталъ	ʔʷataːɬ
ӏотэн	ʔʷatan
ӏоф	ʔʷaf
ӏофшӏакӏэ	ʔʷafʃʼaːt͡ʃʼa
ӏофшӏэгъу	ʔʷafʃʼaʁʷ
ӏофшӏэн	ʔʷafʃʼan
ӏофшӏэнынчъэ	ʔʷafʃʼanənt͡ʂa
ӏофы	ʔʷafə
ӏофыгъу	ʔʷafəʁʷ
ӏофынчъэ	ʔʷafənt͡ʂa
ӏофытхьабз	ʔʷafətħaːbz
ӏофытэн	ʔʷafətan
ӏохъун	ʔʷaχʷən
ӏу	ʔʷə
ӏуагъэ	ʔʷaːʁa
ӏуашъхьэ	ʔʷaːʂħa
ӏуашъхьэмафэ	ʔʷaːʂħamaːfa
ӏугъо	ʔʷəʁʷa
ӏугъуашъо	ʔʷəʁʷaʃʷa
ӏугъэкӏын	ʔʷaʁat͡ʃʼən
ӏудан	ʔʷədaːn
ӏужъу	ʔʷaʐʷə
ӏукьын	ʔʷakʲən
ӏукӏын	ʔʷat͡ʃʼən
ӏукӏыхьан	ʔʷət͡ʃəħaːn
ӏукӏьыбзэ	ʔʷəkʲʼəbza
ӏукӏэн	ʔʷət͡ʃan
ӏукӏэхьан	ʔʷət͡ʃʼaħaːn
ӏул	ʔʷəɮ
ӏулэ	ʔʷəɮa
ӏулэлын	ʔʷəlalən
ӏулӏэн	ʔʷəɬʼan
ӏумпэм	ʔʷampam
ӏун	ʔʷən
ӏункӏыбзэ	ʔʷənt͡ʃʼəbza
ӏункӏэн	ʔʷənt͡ʃʼan
ӏунэн	ʔʷənan
ӏупс	ʔʷəp
ӏупчъэпчъэн	ʔʷəpt͡ʂapt͡ʂan
ӏупшӏэ	ʔʷəpʃʼa
ӏупэ	ʔʷəpa
ӏупэлэн	ʔʷəpalan
ӏуртӏагъ	ʔʷəntʼaːʁ
ӏус	ʔʷəs
ӏухын	ʔʷəxən
ӏухьан	ʔʷəħaːn
ӏуш	ʔʷəʃ
ӏушъо	ʔʷəʃʷa
ӏушъэшъэн	ʔʷəʂaʂan
ӏущэщэн	ʔʷəɕaɕan
ӏыгъэн	ʔəʁan
ӏынджыр	ʔənd͡ʒər
ӏыхын	ʔəxən
ӏьалэ	ʔʲaːla
ӏэ	ʔa
ӏэбжъанэ	ʔabʐaːna
ӏэбжъэнэпыупкӏы	ʔabʐanapəwpt͡ʃə
ӏэбжыб	ʔabʒəb
ӏэбжым	ʔabʒəmə
ӏэбыцу	ʔabət͡sʷ
ӏэбычъу	ʔabət͡ʃʷ
ӏэбэн	ʔaban
ӏэгу	ʔaɡʷ
ӏэгуау	ʔaɡʷaːw
ӏэгъуапэ	ʔaʁʷaːpa
ӏэгьы	ʔaɡʲə
ӏэгьэ	ʔaɡʲa
ӏэдакъэ	ʔadaːqa
ӏэджэбыжэ	ʔad͡ʒabəʒa
ӏэдэб	ʔadab
ӏэзэ	ʔaza
ӏэзэгъу	ʔazəʁʷ
ӏэкощ	ʔakʷʼaɕ
ӏэкӏэгъэхьан	ʔət͡ʃʼaħaːn
ӏэкӏэзын	ʔat͡ʃʼazən
ӏэкӏэкӏын	ʔat͡ʃʼat͡ʃʼən
ӏэкӏэукӏэн	ʔat͡ʃʼawt͡ʃʼan
ӏэкӏэхьан	ʔət͡ʃʼaħaːn
ӏэл	ʔaɮ
ӏэлгьанэ	ʔalɡʲaːana
ӏэлджанэ	ʔald͡ʒaːana
ӏэлъмэкъ	ʔaɬmaq
ӏэлъын	ʔaɬən
ӏэмал	ʔamaːl
ӏэмэпсымэ	ʔamapsəma
ӏэнатӏэ	ʔanaːtʼa
ӏэндыкъ	ʔandəq
ӏэнтэгъу	ʔantaʁʷ
ӏэнэгъунэ	ʔanaʁʷəna
ӏэнэжъ	ʔanaʐ
ӏэпапсӏэ	ʔapaːpsʼa
ӏэпапцӏэ	ʔapaːpsʼa
ӏэплъэкӏ	ʔapɬat͡ʃ
ӏэплъэкӏжъые	ʔapɬat͡ʃʐəja
ӏэпхъабэ	ʔapχaːba
ӏэпхъотэн	ʔapχʷatan
ӏэпхъощ	ʔapχʷaɕ
ӏэпшъэхъу	ʔapʂaχʷ
ӏэпшэхъу	ʔapʃaχʷ
ӏэпыгъэзын	ʔapəʁazən
ӏэпыгъэтӏэрын	ʔapəʁatʼarən
ӏэпызын	ʔapəzən
ӏэпыкӏын	ʔapət͡ʃʼən
ӏэпыкӏьын	ʔapəkʲʼən
ӏэпытӏэрын	ʔapətʼarən
ӏэпыӏэгъу	ʔapəʔaʁʷ
ӏэпыӏэн	ʔapəʔan
ӏэпэгъуапэ	ʔapaʁʷaːpa
ӏэпэпс	ʔapaps
ӏэпэпсӏий	ʔapapsʼəj
ӏэпэтӏэрын	ʔapətʼarən
ӏэпэӏас	ʔapaʔaːs
ӏэргъуй	ʔarʁʷəj
ӏэрс	ʔaps
ӏэтын	ʔaːtən
ӏэтэгъ	ʔataʁ
ӏэтэгъу	ʔataʁʷ
ӏэтэжъ	ʔataʐ
ӏэтэчэн	ʔatat͡ʃan
ӏэубытыпӏэ	ʔawbətəpʼa
ӏэхъогъу	ʔaχʷaʁʷ
ӏэхъу	ʔaχʷ
ӏэхъуамбэ	ʔaχʷaːmba
ӏэхын	ʔəxən
ӏэчӏэхьан	ʔat͡ʃʼaħaːn
ӏэшъхьэ	ʔaʂħa
ӏэшъхьэтет	ʔaʂħatajt
ӏэшъхьэхъу	ʔaʂħaχʷ
ӏэшӏу	ʔaʃʷʼə
ӏэшӏэх	ʔaʃʼax
ӏэщхьэ	ʔaɕħa
